circuit_path,circuit_name,initial_area,final_area,best_area,total_area_reduction,total_area_reduction_percent,steps,sequence_length
testcase/MCNC/cm150a/cm150a.aag,cm150a.aag,46,46,46,0,0.0,"[{'step': 1, 'action': 'b', 'area_before': 46, 'area_after': 46, 'area_reduction': 0, 'area_reduction_percent': 0.0, 'best_area_so_far': 46}, {'step': 2, 'action': 'rw', 'area_before': 46, 'area_after': 46, 'area_reduction': 0, 'area_reduction_percent': 0.0, 'best_area_so_far': 46}, {'step': 3, 'action': 'rf', 'area_before': 46, 'area_after': 46, 'area_reduction': 0, 'area_reduction_percent': 0.0, 'best_area_so_far': 46}, {'step': 4, 'action': 'b', 'area_before': 46, 'area_after': 46, 'area_reduction': 0, 'area_reduction_percent': 0.0, 'best_area_so_far': 46}, {'step': 5, 'action': 'rw', 'area_before': 46, 'area_after': 46, 'area_reduction': 0, 'area_reduction_percent': 0.0, 'best_area_so_far': 46}, {'step': 6, 'action': 'rwz', 'area_before': 46, 'area_after': 46, 'area_reduction': 0, 'area_reduction_percent': 0.0, 'best_area_so_far': 46}, {'step': 7, 'action': 'b', 'area_before': 46, 'area_after': 46, 'area_reduction': 0, 'area_reduction_percent': 0.0, 'best_area_so_far': 46}, {'step': 8, 'action': 'rfz', 'area_before': 46, 'area_after': 46, 'area_reduction': 0, 'area_reduction_percent': 0.0, 'best_area_so_far': 46}, {'step': 9, 'action': 'rwz', 'area_before': 46, 'area_after': 46, 'area_reduction': 0, 'area_reduction_percent': 0.0, 'best_area_so_far': 46}, {'step': 10, 'action': 'b', 'area_before': 46, 'area_after': 46, 'area_reduction': 0, 'area_reduction_percent': 0.0, 'best_area_so_far': 46}]",10
testcase/IWLS/ex93/ex93.aag,ex93.aag,122,77,77,45,36.885245901639344,"[{'step': 1, 'action': 'b', 'area_before': 122, 'area_after': 120, 'area_reduction': 2, 'area_reduction_percent': 1.639344262295082, 'best_area_so_far': 120}, {'step': 2, 'action': 'rw', 'area_before': 120, 'area_after': 99, 'area_reduction': 21, 'area_reduction_percent': 17.5, 'best_area_so_far': 99}, {'step': 3, 'action': 'rf', 'area_before': 99, 'area_after': 82, 'area_reduction': 17, 'area_reduction_percent': 17.17171717171717, 'best_area_so_far': 82}, {'step': 4, 'action': 'b', 'area_before': 82, 'area_after': 80, 'area_reduction': 2, 'area_reduction_percent': 2.4390243902439024, 'best_area_so_far': 80}, {'step': 5, 'action': 'rw', 'area_before': 80, 'area_after': 78, 'area_reduction': 2, 'area_reduction_percent': 2.5, 'best_area_so_far': 78}, {'step': 6, 'action': 'rwz', 'area_before': 78, 'area_after': 78, 'area_reduction': 0, 'area_reduction_percent': 0.0, 'best_area_so_far': 78}, {'step': 7, 'action': 'b', 'area_before': 78, 'area_after': 78, 'area_reduction': 0, 'area_reduction_percent': 0.0, 'best_area_so_far': 78}, {'step': 8, 'action': 'rfz', 'area_before': 78, 'area_after': 78, 'area_reduction': 0, 'area_reduction_percent': 0.0, 'best_area_so_far': 78}, {'step': 9, 'action': 'rwz', 'area_before': 78, 'area_after': 78, 'area_reduction': 0, 'area_reduction_percent': 0.0, 'best_area_so_far': 78}, {'step': 10, 'action': 'b', 'area_before': 78, 'area_after': 77, 'area_reduction': 1, 'area_reduction_percent': 1.282051282051282, 'best_area_so_far': 77}]",10
testcase/MCNC/p82/p82.aag,p82.aag,73,73,73,0,0.0,"[{'step': 1, 'action': 'b', 'area_before': 73, 'area_after': 73, 'area_reduction': 0, 'area_reduction_percent': 0.0, 'best_area_so_far': 73}, {'step': 2, 'action': 'rw', 'area_before': 73, 'area_after': 73, 'area_reduction': 0, 'area_reduction_percent': 0.0, 'best_area_so_far': 73}, {'step': 3, 'action': 'rf', 'area_before': 73, 'area_after': 73, 'area_reduction': 0, 'area_reduction_percent': 0.0, 'best_area_so_far': 73}, {'step': 4, 'action': 'b', 'area_before': 73, 'area_after': 73, 'area_reduction': 0, 'area_reduction_percent': 0.0, 'best_area_so_far': 73}, {'step': 5, 'action': 'rw', 'area_before': 73, 'area_after': 73, 'area_reduction': 0, 'area_reduction_percent': 0.0, 'best_area_so_far': 73}, {'step': 6, 'action': 'rwz', 'area_before': 73, 'area_after': 73, 'area_reduction': 0, 'area_reduction_percent': 0.0, 'best_area_so_far': 73}, {'step': 7, 'action': 'b', 'area_before': 73, 'area_after': 73, 'area_reduction': 0, 'area_reduction_percent': 0.0, 'best_area_so_far': 73}, {'step': 8, 'action': 'rfz', 'area_before': 73, 'area_after': 73, 'area_reduction': 0, 'area_reduction_percent': 0.0, 'best_area_so_far': 73}, {'step': 9, 'action': 'rwz', 'area_before': 73, 'area_after': 73, 'area_reduction': 0, 'area_reduction_percent': 0.0, 'best_area_so_far': 73}, {'step': 10, 'action': 'b', 'area_before': 73, 'area_after': 73, 'area_reduction': 0, 'area_reduction_percent': 0.0, 'best_area_so_far': 73}]",10
testcase/MCNC/x1dn/x1dn.aag,x1dn.aag,156,122,122,34,21.794871794871796,"[{'step': 1, 'action': 'b', 'area_before': 156, 'area_after': 145, 'area_reduction': 11, 'area_reduction_percent': 7.051282051282051, 'best_area_so_far': 145}, {'step': 2, 'action': 'rw', 'area_before': 145, 'area_after': 122, 'area_reduction': 23, 'area_reduction_percent': 15.862068965517242, 'best_area_so_far': 122}, {'step': 3, 'action': 'rf', 'area_before': 122, 'area_after': 122, 'area_reduction': 0, 'area_reduction_percent': 0.0, 'best_area_so_far': 122}, {'step': 4, 'action': 'b', 'area_before': 122, 'area_after': 122, 'area_reduction': 0, 'area_reduction_percent': 0.0, 'best_area_so_far': 122}, {'step': 5, 'action': 'rw', 'area_before': 122, 'area_after': 122, 'area_reduction': 0, 'area_reduction_percent': 0.0, 'best_area_so_far': 122}, {'step': 6, 'action': 'rwz', 'area_before': 122, 'area_after': 122, 'area_reduction': 0, 'area_reduction_percent': 0.0, 'best_area_so_far': 122}, {'step': 7, 'action': 'b', 'area_before': 122, 'area_after': 122, 'area_reduction': 0, 'area_reduction_percent': 0.0, 'best_area_so_far': 122}, {'step': 8, 'action': 'rfz', 'area_before': 122, 'area_after': 122, 'area_reduction': 0, 'area_reduction_percent': 0.0, 'best_area_so_far': 122}, {'step': 9, 'action': 'rwz', 'area_before': 122, 'area_after': 122, 'area_reduction': 0, 'area_reduction_percent': 0.0, 'best_area_so_far': 122}, {'step': 10, 'action': 'b', 'area_before': 122, 'area_after': 122, 'area_reduction': 0, 'area_reduction_percent': 0.0, 'best_area_so_far': 122}]",10
testcase/MCNC/sqrt8/sqrt8.aag,sqrt8.aag,51,51,51,0,0.0,"[{'step': 1, 'action': 'b', 'area_before': 51, 'area_after': 51, 'area_reduction': 0, 'area_reduction_percent': 0.0, 'best_area_so_far': 51}, {'step': 2, 'action': 'rw', 'area_before': 51, 'area_after': 51, 'area_reduction': 0, 'area_reduction_percent': 0.0, 'best_area_so_far': 51}, {'step': 3, 'action': 'rf', 'area_before': 51, 'area_after': 51, 'area_reduction': 0, 'area_reduction_percent': 0.0, 'best_area_so_far': 51}, {'step': 4, 'action': 'b', 'area_before': 51, 'area_after': 51, 'area_reduction': 0, 'area_reduction_percent': 0.0, 'best_area_so_far': 51}, {'step': 5, 'action': 'rw', 'area_before': 51, 'area_after': 51, 'area_reduction': 0, 'area_reduction_percent': 0.0, 'best_area_so_far': 51}, {'step': 6, 'action': 'rwz', 'area_before': 51, 'area_after': 51, 'area_reduction': 0, 'area_reduction_percent': 0.0, 'best_area_so_far': 51}, {'step': 7, 'action': 'b', 'area_before': 51, 'area_after': 51, 'area_reduction': 0, 'area_reduction_percent': 0.0, 'best_area_so_far': 51}, {'step': 8, 'action': 'rfz', 'area_before': 51, 'area_after': 51, 'area_reduction': 0, 'area_reduction_percent': 0.0, 'best_area_so_far': 51}, {'step': 9, 'action': 'rwz', 'area_before': 51, 'area_after': 51, 'area_reduction': 0, 'area_reduction_percent': 0.0, 'best_area_so_far': 51}, {'step': 10, 'action': 'b', 'area_before': 51, 'area_after': 51, 'area_reduction': 0, 'area_reduction_percent': 0.0, 'best_area_so_far': 51}]",10
testcase/MCNC/b2/b2.aag,b2.aag,1814,1278,1278,536,29.54796030871003,"[{'step': 1, 'action': 'b', 'area_before': 1814, 'area_after': 1596, 'area_reduction': 218, 'area_reduction_percent': 12.017640573318634, 'best_area_so_far': 1596}, {'step': 2, 'action': 'rw', 'area_before': 1596, 'area_after': 1447, 'area_reduction': 149, 'area_reduction_percent': 9.335839598997493, 'best_area_so_far': 1447}, {'step': 3, 'action': 'rf', 'area_before': 1447, 'area_after': 1399, 'area_reduction': 48, 'area_reduction_percent': 3.31720801658604, 'best_area_so_far': 1399}, {'step': 4, 'action': 'b', 'area_before': 1399, 'area_after': 1395, 'area_reduction': 4, 'area_reduction_percent': 0.28591851322373124, 'best_area_so_far': 1395}, {'step': 5, 'action': 'rw', 'area_before': 1395, 'area_after': 1362, 'area_reduction': 33, 'area_reduction_percent': 2.3655913978494625, 'best_area_so_far': 1362}, {'step': 6, 'action': 'rwz', 'area_before': 1362, 'area_after': 1335, 'area_reduction': 27, 'area_reduction_percent': 1.9823788546255507, 'best_area_so_far': 1335}, {'step': 7, 'action': 'b', 'area_before': 1335, 'area_after': 1321, 'area_reduction': 14, 'area_reduction_percent': 1.0486891385767791, 'best_area_so_far': 1321}, {'step': 8, 'action': 'rfz', 'area_before': 1321, 'area_after': 1310, 'area_reduction': 11, 'area_reduction_percent': 0.8327024981074944, 'best_area_so_far': 1310}, {'step': 9, 'action': 'rwz', 'area_before': 1310, 'area_after': 1282, 'area_reduction': 28, 'area_reduction_percent': 2.1374045801526718, 'best_area_so_far': 1282}, {'step': 10, 'action': 'b', 'area_before': 1282, 'area_after': 1278, 'area_reduction': 4, 'area_reduction_percent': 0.31201248049922, 'best_area_so_far': 1278}]",10
testcase/MCNC/cps/cps.aag,cps.aag,1928,1250,1250,678,35.16597510373444,"[{'step': 1, 'action': 'b', 'area_before': 1928, 'area_after': 1415, 'area_reduction': 513, 'area_reduction_percent': 26.607883817427386, 'best_area_so_far': 1415}, {'step': 2, 'action': 'rw', 'area_before': 1415, 'area_after': 1319, 'area_reduction': 96, 'area_reduction_percent': 6.784452296819787, 'best_area_so_far': 1319}, {'step': 3, 'action': 'rf', 'area_before': 1319, 'area_after': 1310, 'area_reduction': 9, 'area_reduction_percent': 0.6823351023502654, 'best_area_so_far': 1310}, {'step': 4, 'action': 'b', 'area_before': 1310, 'area_after': 1308, 'area_reduction': 2, 'area_reduction_percent': 0.15267175572519084, 'best_area_so_far': 1308}, {'step': 5, 'action': 'rw', 'area_before': 1308, 'area_after': 1303, 'area_reduction': 5, 'area_reduction_percent': 0.382262996941896, 'best_area_so_far': 1303}, {'step': 6, 'action': 'rwz', 'area_before': 1303, 'area_after': 1281, 'area_reduction': 22, 'area_reduction_percent': 1.688411358403684, 'best_area_so_far': 1281}, {'step': 7, 'action': 'b', 'area_before': 1281, 'area_after': 1275, 'area_reduction': 6, 'area_reduction_percent': 0.468384074941452, 'best_area_so_far': 1275}, {'step': 8, 'action': 'rfz', 'area_before': 1275, 'area_after': 1272, 'area_reduction': 3, 'area_reduction_percent': 0.2352941176470588, 'best_area_so_far': 1272}, {'step': 9, 'action': 'rwz', 'area_before': 1272, 'area_after': 1251, 'area_reduction': 21, 'area_reduction_percent': 1.650943396226415, 'best_area_so_far': 1251}, {'step': 10, 'action': 'b', 'area_before': 1251, 'area_after': 1250, 'area_reduction': 1, 'area_reduction_percent': 0.07993605115907274, 'best_area_so_far': 1250}]",10
testcase/MCNC/t481/t481.aag,t481.aag,441,431,431,10,2.2675736961451247,"[{'step': 1, 'action': 'b', 'area_before': 441, 'area_after': 441, 'area_reduction': 0, 'area_reduction_percent': 0.0, 'best_area_so_far': 441}, {'step': 2, 'action': 'rw', 'area_before': 441, 'area_after': 439, 'area_reduction': 2, 'area_reduction_percent': 0.45351473922902497, 'best_area_so_far': 439}, {'step': 3, 'action': 'rf', 'area_before': 439, 'area_after': 438, 'area_reduction': 1, 'area_reduction_percent': 0.22779043280182232, 'best_area_so_far': 438}, {'step': 4, 'action': 'b', 'area_before': 438, 'area_after': 438, 'area_reduction': 0, 'area_reduction_percent': 0.0, 'best_area_so_far': 438}, {'step': 5, 'action': 'rw', 'area_before': 438, 'area_after': 436, 'area_reduction': 2, 'area_reduction_percent': 0.45662100456621, 'best_area_so_far': 436}, {'step': 6, 'action': 'rwz', 'area_before': 436, 'area_after': 433, 'area_reduction': 3, 'area_reduction_percent': 0.6880733944954129, 'best_area_so_far': 433}, {'step': 7, 'action': 'b', 'area_before': 433, 'area_after': 433, 'area_reduction': 0, 'area_reduction_percent': 0.0, 'best_area_so_far': 433}, {'step': 8, 'action': 'rfz', 'area_before': 433, 'area_after': 431, 'area_reduction': 2, 'area_reduction_percent': 0.4618937644341801, 'best_area_so_far': 431}, {'step': 9, 'action': 'rwz', 'area_before': 431, 'area_after': 431, 'area_reduction': 0, 'area_reduction_percent': 0.0, 'best_area_so_far': 431}, {'step': 10, 'action': 'b', 'area_before': 431, 'area_after': 431, 'area_reduction': 0, 'area_reduction_percent': 0.0, 'best_area_so_far': 431}]",10
testcase/IWLS/ex72/ex72.aag,ex72.aag,4227,3455,3455,772,18.26354388455169,"[{'step': 1, 'action': 'b', 'area_before': 4227, 'area_after': 3905, 'area_reduction': 322, 'area_reduction_percent': 7.617695765318193, 'best_area_so_far': 3905}, {'step': 2, 'action': 'rw', 'area_before': 3905, 'area_after': 3673, 'area_reduction': 232, 'area_reduction_percent': 5.941101152368758, 'best_area_so_far': 3673}, {'step': 3, 'action': 'rf', 'area_before': 3673, 'area_after': 3612, 'area_reduction': 61, 'area_reduction_percent': 1.6607677647699426, 'best_area_so_far': 3612}, {'step': 4, 'action': 'b', 'area_before': 3612, 'area_after': 3602, 'area_reduction': 10, 'area_reduction_percent': 0.2768549280177187, 'best_area_so_far': 3602}, {'step': 5, 'action': 'rw', 'area_before': 3602, 'area_after': 3568, 'area_reduction': 34, 'area_reduction_percent': 0.9439200444197668, 'best_area_so_far': 3568}, {'step': 6, 'action': 'rwz', 'area_before': 3568, 'area_after': 3529, 'area_reduction': 39, 'area_reduction_percent': 1.09304932735426, 'best_area_so_far': 3529}, {'step': 7, 'action': 'b', 'area_before': 3529, 'area_after': 3522, 'area_reduction': 7, 'area_reduction_percent': 0.19835647492207426, 'best_area_so_far': 3522}, {'step': 8, 'action': 'rfz', 'area_before': 3522, 'area_after': 3505, 'area_reduction': 17, 'area_reduction_percent': 0.4826802952867689, 'best_area_so_far': 3505}, {'step': 9, 'action': 'rwz', 'area_before': 3505, 'area_after': 3461, 'area_reduction': 44, 'area_reduction_percent': 1.2553495007132667, 'best_area_so_far': 3461}, {'step': 10, 'action': 'b', 'area_before': 3461, 'area_after': 3455, 'area_reduction': 6, 'area_reduction_percent': 0.17336030049118753, 'best_area_so_far': 3455}]",10
testcase/MCNC/cm162a/cm162a.aag,cm162a.aag,32,32,32,0,0.0,"[{'step': 1, 'action': 'b', 'area_before': 32, 'area_after': 32, 'area_reduction': 0, 'area_reduction_percent': 0.0, 'best_area_so_far': 32}, {'step': 2, 'action': 'rw', 'area_before': 32, 'area_after': 32, 'area_reduction': 0, 'area_reduction_percent': 0.0, 'best_area_so_far': 32}, {'step': 3, 'action': 'rf', 'area_before': 32, 'area_after': 32, 'area_reduction': 0, 'area_reduction_percent': 0.0, 'best_area_so_far': 32}, {'step': 4, 'action': 'b', 'area_before': 32, 'area_after': 32, 'area_reduction': 0, 'area_reduction_percent': 0.0, 'best_area_so_far': 32}, {'step': 5, 'action': 'rw', 'area_before': 32, 'area_after': 32, 'area_reduction': 0, 'area_reduction_percent': 0.0, 'best_area_so_far': 32}, {'step': 6, 'action': 'rwz', 'area_before': 32, 'area_after': 32, 'area_reduction': 0, 'area_reduction_percent': 0.0, 'best_area_so_far': 32}, {'step': 7, 'action': 'b', 'area_before': 32, 'area_after': 32, 'area_reduction': 0, 'area_reduction_percent': 0.0, 'best_area_so_far': 32}, {'step': 8, 'action': 'rfz', 'area_before': 32, 'area_after': 32, 'area_reduction': 0, 'area_reduction_percent': 0.0, 'best_area_so_far': 32}, {'step': 9, 'action': 'rwz', 'area_before': 32, 'area_after': 32, 'area_reduction': 0, 'area_reduction_percent': 0.0, 'best_area_so_far': 32}, {'step': 10, 'action': 'b', 'area_before': 32, 'area_after': 32, 'area_reduction': 0, 'area_reduction_percent': 0.0, 'best_area_so_far': 32}]",10
testcase/MCNC/k2/k2.aag,k2.aag,1998,1234,1234,764,38.23823823823824,"[{'step': 1, 'action': 'b', 'area_before': 1998, 'area_after': 1505, 'area_reduction': 493, 'area_reduction_percent': 24.674674674674673, 'best_area_so_far': 1505}, {'step': 2, 'action': 'rw', 'area_before': 1505, 'area_after': 1397, 'area_reduction': 108, 'area_reduction_percent': 7.176079734219269, 'best_area_so_far': 1397}, {'step': 3, 'action': 'rf', 'area_before': 1397, 'area_after': 1384, 'area_reduction': 13, 'area_reduction_percent': 0.9305654974946312, 'best_area_so_far': 1384}, {'step': 4, 'action': 'b', 'area_before': 1384, 'area_after': 1357, 'area_reduction': 27, 'area_reduction_percent': 1.9508670520231215, 'best_area_so_far': 1357}, {'step': 5, 'action': 'rw', 'area_before': 1357, 'area_after': 1319, 'area_reduction': 38, 'area_reduction_percent': 2.800294767870302, 'best_area_so_far': 1319}, {'step': 6, 'action': 'rwz', 'area_before': 1319, 'area_after': 1293, 'area_reduction': 26, 'area_reduction_percent': 1.9711902956785443, 'best_area_so_far': 1293}, {'step': 7, 'action': 'b', 'area_before': 1293, 'area_after': 1274, 'area_reduction': 19, 'area_reduction_percent': 1.4694508894044858, 'best_area_so_far': 1274}, {'step': 8, 'action': 'rfz', 'area_before': 1274, 'area_after': 1270, 'area_reduction': 4, 'area_reduction_percent': 0.3139717425431711, 'best_area_so_far': 1270}, {'step': 9, 'action': 'rwz', 'area_before': 1270, 'area_after': 1243, 'area_reduction': 27, 'area_reduction_percent': 2.1259842519685037, 'best_area_so_far': 1243}, {'step': 10, 'action': 'b', 'area_before': 1243, 'area_after': 1234, 'area_reduction': 9, 'area_reduction_percent': 0.7240547063555913, 'best_area_so_far': 1234}]",10
testcase/IWLS/ex121/ex121.aag,ex121.aag,2160,1716,1716,444,20.555555555555554,"[{'step': 1, 'action': 'b', 'area_before': 2160, 'area_after': 2013, 'area_reduction': 147, 'area_reduction_percent': 6.805555555555555, 'best_area_so_far': 2013}, {'step': 2, 'action': 'rw', 'area_before': 2013, 'area_after': 1854, 'area_reduction': 159, 'area_reduction_percent': 7.898658718330849, 'best_area_so_far': 1854}, {'step': 3, 'action': 'rf', 'area_before': 1854, 'area_after': 1805, 'area_reduction': 49, 'area_reduction_percent': 2.6429341963322543, 'best_area_so_far': 1805}, {'step': 4, 'action': 'b', 'area_before': 1805, 'area_after': 1795, 'area_reduction': 10, 'area_reduction_percent': 0.554016620498615, 'best_area_so_far': 1795}, {'step': 5, 'action': 'rw', 'area_before': 1795, 'area_after': 1769, 'area_reduction': 26, 'area_reduction_percent': 1.448467966573816, 'best_area_so_far': 1769}, {'step': 6, 'action': 'rwz', 'area_before': 1769, 'area_after': 1752, 'area_reduction': 17, 'area_reduction_percent': 0.9609949123798756, 'best_area_so_far': 1752}, {'step': 7, 'action': 'b', 'area_before': 1752, 'area_after': 1745, 'area_reduction': 7, 'area_reduction_percent': 0.3995433789954338, 'best_area_so_far': 1745}, {'step': 8, 'action': 'rfz', 'area_before': 1745, 'area_after': 1741, 'area_reduction': 4, 'area_reduction_percent': 0.2292263610315186, 'best_area_so_far': 1741}, {'step': 9, 'action': 'rwz', 'area_before': 1741, 'area_after': 1717, 'area_reduction': 24, 'area_reduction_percent': 1.3785180930499714, 'best_area_so_far': 1717}, {'step': 10, 'action': 'b', 'area_before': 1717, 'area_after': 1716, 'area_reduction': 1, 'area_reduction_percent': 0.05824111822947001, 'best_area_so_far': 1716}]",10
testcase/MCNC/apla/apla.aag,apla.aag,277,183,183,94,33.935018050541515,"[{'step': 1, 'action': 'b', 'area_before': 277, 'area_after': 232, 'area_reduction': 45, 'area_reduction_percent': 16.24548736462094, 'best_area_so_far': 232}, {'step': 2, 'action': 'rw', 'area_before': 232, 'area_after': 216, 'area_reduction': 16, 'area_reduction_percent': 6.896551724137931, 'best_area_so_far': 216}, {'step': 3, 'action': 'rf', 'area_before': 216, 'area_after': 205, 'area_reduction': 11, 'area_reduction_percent': 5.092592592592593, 'best_area_so_far': 205}, {'step': 4, 'action': 'b', 'area_before': 205, 'area_after': 202, 'area_reduction': 3, 'area_reduction_percent': 1.4634146341463417, 'best_area_so_far': 202}, {'step': 5, 'action': 'rw', 'area_before': 202, 'area_after': 193, 'area_reduction': 9, 'area_reduction_percent': 4.455445544554455, 'best_area_so_far': 193}, {'step': 6, 'action': 'rwz', 'area_before': 193, 'area_after': 189, 'area_reduction': 4, 'area_reduction_percent': 2.072538860103627, 'best_area_so_far': 189}, {'step': 7, 'action': 'b', 'area_before': 189, 'area_after': 187, 'area_reduction': 2, 'area_reduction_percent': 1.0582010582010581, 'best_area_so_far': 187}, {'step': 8, 'action': 'rfz', 'area_before': 187, 'area_after': 187, 'area_reduction': 0, 'area_reduction_percent': 0.0, 'best_area_so_far': 187}, {'step': 9, 'action': 'rwz', 'area_before': 187, 'area_after': 184, 'area_reduction': 3, 'area_reduction_percent': 1.6042780748663104, 'best_area_so_far': 184}, {'step': 10, 'action': 'b', 'area_before': 184, 'area_after': 183, 'area_reduction': 1, 'area_reduction_percent': 0.5434782608695652, 'best_area_so_far': 183}]",10
testcase/MCNC/tms/tms.aag,tms.aag,246,225,225,21,8.536585365853659,"[{'step': 1, 'action': 'b', 'area_before': 246, 'area_after': 246, 'area_reduction': 0, 'area_reduction_percent': 0.0, 'best_area_so_far': 246}, {'step': 2, 'action': 'rw', 'area_before': 246, 'area_after': 244, 'area_reduction': 2, 'area_reduction_percent': 0.8130081300813009, 'best_area_so_far': 244}, {'step': 3, 'action': 'rf', 'area_before': 244, 'area_after': 235, 'area_reduction': 9, 'area_reduction_percent': 3.6885245901639343, 'best_area_so_far': 235}, {'step': 4, 'action': 'b', 'area_before': 235, 'area_after': 232, 'area_reduction': 3, 'area_reduction_percent': 1.276595744680851, 'best_area_so_far': 232}, {'step': 5, 'action': 'rw', 'area_before': 232, 'area_after': 228, 'area_reduction': 4, 'area_reduction_percent': 1.7241379310344827, 'best_area_so_far': 228}, {'step': 6, 'action': 'rwz', 'area_before': 228, 'area_after': 228, 'area_reduction': 0, 'area_reduction_percent': 0.0, 'best_area_so_far': 228}, {'step': 7, 'action': 'b', 'area_before': 228, 'area_after': 228, 'area_reduction': 0, 'area_reduction_percent': 0.0, 'best_area_so_far': 228}, {'step': 8, 'action': 'rfz', 'area_before': 228, 'area_after': 227, 'area_reduction': 1, 'area_reduction_percent': 0.43859649122807015, 'best_area_so_far': 227}, {'step': 9, 'action': 'rwz', 'area_before': 227, 'area_after': 225, 'area_reduction': 2, 'area_reduction_percent': 0.881057268722467, 'best_area_so_far': 225}, {'step': 10, 'action': 'b', 'area_before': 225, 'area_after': 225, 'area_reduction': 0, 'area_reduction_percent': 0.0, 'best_area_so_far': 225}]",10
testcase/IWLS/ex44/ex44.aag,ex44.aag,334,228,228,106,31.736526946107784,"[{'step': 1, 'action': 'b', 'area_before': 334, 'area_after': 315, 'area_reduction': 19, 'area_reduction_percent': 5.688622754491018, 'best_area_so_far': 315}, {'step': 2, 'action': 'rw', 'area_before': 315, 'area_after': 274, 'area_reduction': 41, 'area_reduction_percent': 13.015873015873018, 'best_area_so_far': 274}, {'step': 3, 'action': 'rf', 'area_before': 274, 'area_after': 249, 'area_reduction': 25, 'area_reduction_percent': 9.124087591240876, 'best_area_so_far': 249}, {'step': 4, 'action': 'b', 'area_before': 249, 'area_after': 245, 'area_reduction': 4, 'area_reduction_percent': 1.6064257028112447, 'best_area_so_far': 245}, {'step': 5, 'action': 'rw', 'area_before': 245, 'area_after': 240, 'area_reduction': 5, 'area_reduction_percent': 2.0408163265306123, 'best_area_so_far': 240}, {'step': 6, 'action': 'rwz', 'area_before': 240, 'area_after': 239, 'area_reduction': 1, 'area_reduction_percent': 0.4166666666666667, 'best_area_so_far': 239}, {'step': 7, 'action': 'b', 'area_before': 239, 'area_after': 237, 'area_reduction': 2, 'area_reduction_percent': 0.8368200836820083, 'best_area_so_far': 237}, {'step': 8, 'action': 'rfz', 'area_before': 237, 'area_after': 229, 'area_reduction': 8, 'area_reduction_percent': 3.375527426160337, 'best_area_so_far': 229}, {'step': 9, 'action': 'rwz', 'area_before': 229, 'area_after': 228, 'area_reduction': 1, 'area_reduction_percent': 0.43668122270742354, 'best_area_so_far': 228}, {'step': 10, 'action': 'b', 'area_before': 228, 'area_after': 228, 'area_reduction': 0, 'area_reduction_percent': 0.0, 'best_area_so_far': 228}]",10
testcase/MCNC/b12/b12.aag,b12.aag,74,53,53,21,28.37837837837838,"[{'step': 1, 'action': 'b', 'area_before': 74, 'area_after': 74, 'area_reduction': 0, 'area_reduction_percent': 0.0, 'best_area_so_far': 74}, {'step': 2, 'action': 'rw', 'area_before': 74, 'area_after': 73, 'area_reduction': 1, 'area_reduction_percent': 1.3513513513513513, 'best_area_so_far': 73}, {'step': 3, 'action': 'rf', 'area_before': 73, 'area_after': 59, 'area_reduction': 14, 'area_reduction_percent': 19.17808219178082, 'best_area_so_far': 59}, {'step': 4, 'action': 'b', 'area_before': 59, 'area_after': 57, 'area_reduction': 2, 'area_reduction_percent': 3.389830508474576, 'best_area_so_far': 57}, {'step': 5, 'action': 'rw', 'area_before': 57, 'area_after': 57, 'area_reduction': 0, 'area_reduction_percent': 0.0, 'best_area_so_far': 57}, {'step': 6, 'action': 'rwz', 'area_before': 57, 'area_after': 57, 'area_reduction': 0, 'area_reduction_percent': 0.0, 'best_area_so_far': 57}, {'step': 7, 'action': 'b', 'area_before': 57, 'area_after': 57, 'area_reduction': 0, 'area_reduction_percent': 0.0, 'best_area_so_far': 57}, {'step': 8, 'action': 'rfz', 'area_before': 57, 'area_after': 57, 'area_reduction': 0, 'area_reduction_percent': 0.0, 'best_area_so_far': 57}, {'step': 9, 'action': 'rwz', 'area_before': 57, 'area_after': 53, 'area_reduction': 4, 'area_reduction_percent': 7.017543859649122, 'best_area_so_far': 53}, {'step': 10, 'action': 'b', 'area_before': 53, 'area_after': 53, 'area_reduction': 0, 'area_reduction_percent': 0.0, 'best_area_so_far': 53}]",10
testcase/MCNC/clip/clip.aag,clip.aag,216,186,186,30,13.88888888888889,"[{'step': 1, 'action': 'b', 'area_before': 216, 'area_after': 215, 'area_reduction': 1, 'area_reduction_percent': 0.4629629629629629, 'best_area_so_far': 215}, {'step': 2, 'action': 'rw', 'area_before': 215, 'area_after': 209, 'area_reduction': 6, 'area_reduction_percent': 2.7906976744186047, 'best_area_so_far': 209}, {'step': 3, 'action': 'rf', 'area_before': 209, 'area_after': 202, 'area_reduction': 7, 'area_reduction_percent': 3.349282296650718, 'best_area_so_far': 202}, {'step': 4, 'action': 'b', 'area_before': 202, 'area_after': 202, 'area_reduction': 0, 'area_reduction_percent': 0.0, 'best_area_so_far': 202}, {'step': 5, 'action': 'rw', 'area_before': 202, 'area_after': 199, 'area_reduction': 3, 'area_reduction_percent': 1.4851485148514851, 'best_area_so_far': 199}, {'step': 6, 'action': 'rwz', 'area_before': 199, 'area_after': 197, 'area_reduction': 2, 'area_reduction_percent': 1.0050251256281406, 'best_area_so_far': 197}, {'step': 7, 'action': 'b', 'area_before': 197, 'area_after': 197, 'area_reduction': 0, 'area_reduction_percent': 0.0, 'best_area_so_far': 197}, {'step': 8, 'action': 'rfz', 'area_before': 197, 'area_after': 192, 'area_reduction': 5, 'area_reduction_percent': 2.5380710659898478, 'best_area_so_far': 192}, {'step': 9, 'action': 'rwz', 'area_before': 192, 'area_after': 186, 'area_reduction': 6, 'area_reduction_percent': 3.125, 'best_area_so_far': 186}, {'step': 10, 'action': 'b', 'area_before': 186, 'area_after': 186, 'area_reduction': 0, 'area_reduction_percent': 0.0, 'best_area_so_far': 186}]",10
testcase/MCNC/spla/spla.aag,spla.aag,1747,883,883,864,49.45621064682312,"[{'step': 1, 'action': 'b', 'area_before': 1747, 'area_after': 1317, 'area_reduction': 430, 'area_reduction_percent': 24.613623354321696, 'best_area_so_far': 1317}, {'step': 2, 'action': 'rw', 'area_before': 1317, 'area_after': 1137, 'area_reduction': 180, 'area_reduction_percent': 13.66742596810934, 'best_area_so_far': 1137}, {'step': 3, 'action': 'rf', 'area_before': 1137, 'area_after': 1047, 'area_reduction': 90, 'area_reduction_percent': 7.9155672823219, 'best_area_so_far': 1047}, {'step': 4, 'action': 'b', 'area_before': 1047, 'area_after': 1020, 'area_reduction': 27, 'area_reduction_percent': 2.5787965616045847, 'best_area_so_far': 1020}, {'step': 5, 'action': 'rw', 'area_before': 1020, 'area_after': 969, 'area_reduction': 51, 'area_reduction_percent': 5.0, 'best_area_so_far': 969}, {'step': 6, 'action': 'rwz', 'area_before': 969, 'area_after': 949, 'area_reduction': 20, 'area_reduction_percent': 2.063983488132095, 'best_area_so_far': 949}, {'step': 7, 'action': 'b', 'area_before': 949, 'area_after': 947, 'area_reduction': 2, 'area_reduction_percent': 0.21074815595363539, 'best_area_so_far': 947}, {'step': 8, 'action': 'rfz', 'area_before': 947, 'area_after': 916, 'area_reduction': 31, 'area_reduction_percent': 3.2734952481520594, 'best_area_so_far': 916}, {'step': 9, 'action': 'rwz', 'area_before': 916, 'area_after': 883, 'area_reduction': 33, 'area_reduction_percent': 3.602620087336245, 'best_area_so_far': 883}, {'step': 10, 'action': 'b', 'area_before': 883, 'area_after': 883, 'area_reduction': 0, 'area_reduction_percent': 0.0, 'best_area_so_far': 883}]",10
testcase/MCNC/mlp4/mlp4.aag,mlp4.aag,252,244,244,8,3.1746031746031744,"[{'step': 1, 'action': 'b', 'area_before': 252, 'area_after': 252, 'area_reduction': 0, 'area_reduction_percent': 0.0, 'best_area_so_far': 252}, {'step': 2, 'action': 'rw', 'area_before': 252, 'area_after': 250, 'area_reduction': 2, 'area_reduction_percent': 0.7936507936507936, 'best_area_so_far': 250}, {'step': 3, 'action': 'rf', 'area_before': 250, 'area_after': 249, 'area_reduction': 1, 'area_reduction_percent': 0.4, 'best_area_so_far': 249}, {'step': 4, 'action': 'b', 'area_before': 249, 'area_after': 249, 'area_reduction': 0, 'area_reduction_percent': 0.0, 'best_area_so_far': 249}, {'step': 5, 'action': 'rw', 'area_before': 249, 'area_after': 247, 'area_reduction': 2, 'area_reduction_percent': 0.8032128514056224, 'best_area_so_far': 247}, {'step': 6, 'action': 'rwz', 'area_before': 247, 'area_after': 246, 'area_reduction': 1, 'area_reduction_percent': 0.4048582995951417, 'best_area_so_far': 246}, {'step': 7, 'action': 'b', 'area_before': 246, 'area_after': 246, 'area_reduction': 0, 'area_reduction_percent': 0.0, 'best_area_so_far': 246}, {'step': 8, 'action': 'rfz', 'area_before': 246, 'area_after': 244, 'area_reduction': 2, 'area_reduction_percent': 0.8130081300813009, 'best_area_so_far': 244}, {'step': 9, 'action': 'rwz', 'area_before': 244, 'area_after': 244, 'area_reduction': 0, 'area_reduction_percent': 0.0, 'best_area_so_far': 244}, {'step': 10, 'action': 'b', 'area_before': 244, 'area_after': 244, 'area_reduction': 0, 'area_reduction_percent': 0.0, 'best_area_so_far': 244}]",10
testcase/MCNC/alcom/alcom.aag,alcom.aag,78,77,77,1,1.282051282051282,"[{'step': 1, 'action': 'b', 'area_before': 78, 'area_after': 78, 'area_reduction': 0, 'area_reduction_percent': 0.0, 'best_area_so_far': 78}, {'step': 2, 'action': 'rw', 'area_before': 78, 'area_after': 77, 'area_reduction': 1, 'area_reduction_percent': 1.282051282051282, 'best_area_so_far': 77}, {'step': 3, 'action': 'rf', 'area_before': 77, 'area_after': 77, 'area_reduction': 0, 'area_reduction_percent': 0.0, 'best_area_so_far': 77}, {'step': 4, 'action': 'b', 'area_before': 77, 'area_after': 77, 'area_reduction': 0, 'area_reduction_percent': 0.0, 'best_area_so_far': 77}, {'step': 5, 'action': 'rw', 'area_before': 77, 'area_after': 77, 'area_reduction': 0, 'area_reduction_percent': 0.0, 'best_area_so_far': 77}, {'step': 6, 'action': 'rwz', 'area_before': 77, 'area_after': 77, 'area_reduction': 0, 'area_reduction_percent': 0.0, 'best_area_so_far': 77}, {'step': 7, 'action': 'b', 'area_before': 77, 'area_after': 77, 'area_reduction': 0, 'area_reduction_percent': 0.0, 'best_area_so_far': 77}, {'step': 8, 'action': 'rfz', 'area_before': 77, 'area_after': 77, 'area_reduction': 0, 'area_reduction_percent': 0.0, 'best_area_so_far': 77}, {'step': 9, 'action': 'rwz', 'area_before': 77, 'area_after': 77, 'area_reduction': 0, 'area_reduction_percent': 0.0, 'best_area_so_far': 77}, {'step': 10, 'action': 'b', 'area_before': 77, 'area_after': 77, 'area_reduction': 0, 'area_reduction_percent': 0.0, 'best_area_so_far': 77}]",10
testcase/MCNC/m4/m4.aag,m4.aag,515,500,500,15,2.912621359223301,"[{'step': 1, 'action': 'b', 'area_before': 515, 'area_after': 515, 'area_reduction': 0, 'area_reduction_percent': 0.0, 'best_area_so_far': 515}, {'step': 2, 'action': 'rw', 'area_before': 515, 'area_after': 513, 'area_reduction': 2, 'area_reduction_percent': 0.3883495145631068, 'best_area_so_far': 513}, {'step': 3, 'action': 'rf', 'area_before': 513, 'area_after': 508, 'area_reduction': 5, 'area_reduction_percent': 0.9746588693957114, 'best_area_so_far': 508}, {'step': 4, 'action': 'b', 'area_before': 508, 'area_after': 507, 'area_reduction': 1, 'area_reduction_percent': 0.19685039370078738, 'best_area_so_far': 507}, {'step': 5, 'action': 'rw', 'area_before': 507, 'area_after': 505, 'area_reduction': 2, 'area_reduction_percent': 0.39447731755424065, 'best_area_so_far': 505}, {'step': 6, 'action': 'rwz', 'area_before': 505, 'area_after': 505, 'area_reduction': 0, 'area_reduction_percent': 0.0, 'best_area_so_far': 505}, {'step': 7, 'action': 'b', 'area_before': 505, 'area_after': 505, 'area_reduction': 0, 'area_reduction_percent': 0.0, 'best_area_so_far': 505}, {'step': 8, 'action': 'rfz', 'area_before': 505, 'area_after': 504, 'area_reduction': 1, 'area_reduction_percent': 0.19801980198019803, 'best_area_so_far': 504}, {'step': 9, 'action': 'rwz', 'area_before': 504, 'area_after': 500, 'area_reduction': 4, 'area_reduction_percent': 0.7936507936507936, 'best_area_so_far': 500}, {'step': 10, 'action': 'b', 'area_before': 500, 'area_after': 500, 'area_reduction': 0, 'area_reduction_percent': 0.0, 'best_area_so_far': 500}]",10
testcase/IWLS/ex74/ex74.aag,ex74.aag,4722,3909,3909,813,17.21728081321474,"[{'step': 1, 'action': 'b', 'area_before': 4722, 'area_after': 4334, 'area_reduction': 388, 'area_reduction_percent': 8.21685726387124, 'best_area_so_far': 4334}, {'step': 2, 'action': 'rw', 'area_before': 4334, 'area_after': 4117, 'area_reduction': 217, 'area_reduction_percent': 5.006922011998154, 'best_area_so_far': 4117}, {'step': 3, 'action': 'rf', 'area_before': 4117, 'area_after': 4051, 'area_reduction': 66, 'area_reduction_percent': 1.603109059995142, 'best_area_so_far': 4051}, {'step': 4, 'action': 'b', 'area_before': 4051, 'area_after': 4038, 'area_reduction': 13, 'area_reduction_percent': 0.3209084176746482, 'best_area_so_far': 4038}, {'step': 5, 'action': 'rw', 'area_before': 4038, 'area_after': 4007, 'area_reduction': 31, 'area_reduction_percent': 0.7677067855373947, 'best_area_so_far': 4007}, {'step': 6, 'action': 'rwz', 'area_before': 4007, 'area_after': 3977, 'area_reduction': 30, 'area_reduction_percent': 0.7486897928624906, 'best_area_so_far': 3977}, {'step': 7, 'action': 'b', 'area_before': 3977, 'area_after': 3964, 'area_reduction': 13, 'area_reduction_percent': 0.3268795574553684, 'best_area_so_far': 3964}, {'step': 8, 'action': 'rfz', 'area_before': 3964, 'area_after': 3950, 'area_reduction': 14, 'area_reduction_percent': 0.35317860746720486, 'best_area_so_far': 3950}, {'step': 9, 'action': 'rwz', 'area_before': 3950, 'area_after': 3910, 'area_reduction': 40, 'area_reduction_percent': 1.0126582278481013, 'best_area_so_far': 3910}, {'step': 10, 'action': 'b', 'area_before': 3910, 'area_after': 3909, 'area_reduction': 1, 'area_reduction_percent': 0.025575447570332477, 'best_area_so_far': 3909}]",10
testcase/IWLS/ex92/ex92.aag,ex92.aag,81,48,48,33,40.74074074074074,"[{'step': 1, 'action': 'b', 'area_before': 81, 'area_after': 80, 'area_reduction': 1, 'area_reduction_percent': 1.2345679012345678, 'best_area_so_far': 80}, {'step': 2, 'action': 'rw', 'area_before': 80, 'area_after': 60, 'area_reduction': 20, 'area_reduction_percent': 25.0, 'best_area_so_far': 60}, {'step': 3, 'action': 'rf', 'area_before': 60, 'area_after': 54, 'area_reduction': 6, 'area_reduction_percent': 10.0, 'best_area_so_far': 54}, {'step': 4, 'action': 'b', 'area_before': 54, 'area_after': 52, 'area_reduction': 2, 'area_reduction_percent': 3.7037037037037033, 'best_area_so_far': 52}, {'step': 5, 'action': 'rw', 'area_before': 52, 'area_after': 49, 'area_reduction': 3, 'area_reduction_percent': 5.769230769230769, 'best_area_so_far': 49}, {'step': 6, 'action': 'rwz', 'area_before': 49, 'area_after': 49, 'area_reduction': 0, 'area_reduction_percent': 0.0, 'best_area_so_far': 49}, {'step': 7, 'action': 'b', 'area_before': 49, 'area_after': 49, 'area_reduction': 0, 'area_reduction_percent': 0.0, 'best_area_so_far': 49}, {'step': 8, 'action': 'rfz', 'area_before': 49, 'area_after': 49, 'area_reduction': 0, 'area_reduction_percent': 0.0, 'best_area_so_far': 49}, {'step': 9, 'action': 'rwz', 'area_before': 49, 'area_after': 48, 'area_reduction': 1, 'area_reduction_percent': 2.0408163265306123, 'best_area_so_far': 48}, {'step': 10, 'action': 'b', 'area_before': 48, 'area_after': 48, 'area_reduction': 0, 'area_reduction_percent': 0.0, 'best_area_so_far': 48}]",10
testcase/IWLS/ex157/ex157.aag,ex157.aag,123566,102316,102316,21250,17.197287279672402,"[{'step': 1, 'action': 'b', 'area_before': 123566, 'area_after': 109360, 'area_reduction': 14206, 'area_reduction_percent': 11.49669002800123, 'best_area_so_far': 109360}, {'step': 2, 'action': 'rw', 'area_before': 109360, 'area_after': 105869, 'area_reduction': 3491, 'area_reduction_percent': 3.192209217264082, 'best_area_so_far': 105869}, {'step': 3, 'action': 'rf', 'area_before': 105869, 'area_after': 105026, 'area_reduction': 843, 'area_reduction_percent': 0.7962670847934712, 'best_area_so_far': 105026}, {'step': 4, 'action': 'b', 'area_before': 105026, 'area_after': 104868, 'area_reduction': 158, 'area_reduction_percent': 0.15043893892940793, 'best_area_so_far': 104868}, {'step': 5, 'action': 'rw', 'area_before': 104868, 'area_after': 104242, 'area_reduction': 626, 'area_reduction_percent': 0.5969409161994126, 'best_area_so_far': 104242}, {'step': 6, 'action': 'rwz', 'area_before': 104242, 'area_after': 103482, 'area_reduction': 760, 'area_reduction_percent': 0.7290727345983384, 'best_area_so_far': 103482}, {'step': 7, 'action': 'b', 'area_before': 103482, 'area_after': 103341, 'area_reduction': 141, 'area_reduction_percent': 0.1362555806806981, 'best_area_so_far': 103341}, {'step': 8, 'action': 'rfz', 'area_before': 103341, 'area_after': 103214, 'area_reduction': 127, 'area_reduction_percent': 0.12289410785651386, 'best_area_so_far': 103214}, {'step': 9, 'action': 'rwz', 'area_before': 103214, 'area_after': 102384, 'area_reduction': 830, 'area_reduction_percent': 0.8041544751680973, 'best_area_so_far': 102384}, {'step': 10, 'action': 'b', 'area_before': 102384, 'area_after': 102316, 'area_reduction': 68, 'area_reduction_percent': 0.06641662759806219, 'best_area_so_far': 102316}]",10
testcase/MCNC/C3540/C3540.aag,C3540.aag,954,919,919,35,3.668763102725367,"[{'step': 1, 'action': 'b', 'area_before': 954, 'area_after': 954, 'area_reduction': 0, 'area_reduction_percent': 0.0, 'best_area_so_far': 954}, {'step': 2, 'action': 'rw', 'area_before': 954, 'area_after': 923, 'area_reduction': 31, 'area_reduction_percent': 3.2494758909853245, 'best_area_so_far': 923}, {'step': 3, 'action': 'rf', 'area_before': 923, 'area_after': 923, 'area_reduction': 0, 'area_reduction_percent': 0.0, 'best_area_so_far': 923}, {'step': 4, 'action': 'b', 'area_before': 923, 'area_after': 923, 'area_reduction': 0, 'area_reduction_percent': 0.0, 'best_area_so_far': 923}, {'step': 5, 'action': 'rw', 'area_before': 923, 'area_after': 922, 'area_reduction': 1, 'area_reduction_percent': 0.10834236186348861, 'best_area_so_far': 922}, {'step': 6, 'action': 'rwz', 'area_before': 922, 'area_after': 920, 'area_reduction': 2, 'area_reduction_percent': 0.21691973969631237, 'best_area_so_far': 920}, {'step': 7, 'action': 'b', 'area_before': 920, 'area_after': 920, 'area_reduction': 0, 'area_reduction_percent': 0.0, 'best_area_so_far': 920}, {'step': 8, 'action': 'rfz', 'area_before': 920, 'area_after': 920, 'area_reduction': 0, 'area_reduction_percent': 0.0, 'best_area_so_far': 920}, {'step': 9, 'action': 'rwz', 'area_before': 920, 'area_after': 919, 'area_reduction': 1, 'area_reduction_percent': 0.10869565217391304, 'best_area_so_far': 919}, {'step': 10, 'action': 'b', 'area_before': 919, 'area_after': 919, 'area_reduction': 0, 'area_reduction_percent': 0.0, 'best_area_so_far': 919}]",10
testcase/IWLS/ex56/ex56.aag,ex56.aag,315,213,213,102,32.38095238095238,"[{'step': 1, 'action': 'b', 'area_before': 315, 'area_after': 299, 'area_reduction': 16, 'area_reduction_percent': 5.079365079365079, 'best_area_so_far': 299}, {'step': 2, 'action': 'rw', 'area_before': 299, 'area_after': 245, 'area_reduction': 54, 'area_reduction_percent': 18.06020066889632, 'best_area_so_far': 245}, {'step': 3, 'action': 'rf', 'area_before': 245, 'area_after': 232, 'area_reduction': 13, 'area_reduction_percent': 5.3061224489795915, 'best_area_so_far': 232}, {'step': 4, 'action': 'b', 'area_before': 232, 'area_after': 229, 'area_reduction': 3, 'area_reduction_percent': 1.293103448275862, 'best_area_so_far': 229}, {'step': 5, 'action': 'rw', 'area_before': 229, 'area_after': 220, 'area_reduction': 9, 'area_reduction_percent': 3.9301310043668125, 'best_area_so_far': 220}, {'step': 6, 'action': 'rwz', 'area_before': 220, 'area_after': 219, 'area_reduction': 1, 'area_reduction_percent': 0.45454545454545453, 'best_area_so_far': 219}, {'step': 7, 'action': 'b', 'area_before': 219, 'area_after': 219, 'area_reduction': 0, 'area_reduction_percent': 0.0, 'best_area_so_far': 219}, {'step': 8, 'action': 'rfz', 'area_before': 219, 'area_after': 215, 'area_reduction': 4, 'area_reduction_percent': 1.82648401826484, 'best_area_so_far': 215}, {'step': 9, 'action': 'rwz', 'area_before': 215, 'area_after': 213, 'area_reduction': 2, 'area_reduction_percent': 0.9302325581395349, 'best_area_so_far': 213}, {'step': 10, 'action': 'b', 'area_before': 213, 'area_after': 213, 'area_reduction': 0, 'area_reduction_percent': 0.0, 'best_area_so_far': 213}]",10
testcase/MCNC/misex1/misex1.aag,misex1.aag,50,50,50,0,0.0,"[{'step': 1, 'action': 'b', 'area_before': 50, 'area_after': 50, 'area_reduction': 0, 'area_reduction_percent': 0.0, 'best_area_so_far': 50}, {'step': 2, 'action': 'rw', 'area_before': 50, 'area_after': 50, 'area_reduction': 0, 'area_reduction_percent': 0.0, 'best_area_so_far': 50}, {'step': 3, 'action': 'rf', 'area_before': 50, 'area_after': 50, 'area_reduction': 0, 'area_reduction_percent': 0.0, 'best_area_so_far': 50}, {'step': 4, 'action': 'b', 'area_before': 50, 'area_after': 50, 'area_reduction': 0, 'area_reduction_percent': 0.0, 'best_area_so_far': 50}, {'step': 5, 'action': 'rw', 'area_before': 50, 'area_after': 50, 'area_reduction': 0, 'area_reduction_percent': 0.0, 'best_area_so_far': 50}, {'step': 6, 'action': 'rwz', 'area_before': 50, 'area_after': 50, 'area_reduction': 0, 'area_reduction_percent': 0.0, 'best_area_so_far': 50}, {'step': 7, 'action': 'b', 'area_before': 50, 'area_after': 50, 'area_reduction': 0, 'area_reduction_percent': 0.0, 'best_area_so_far': 50}, {'step': 8, 'action': 'rfz', 'area_before': 50, 'area_after': 50, 'area_reduction': 0, 'area_reduction_percent': 0.0, 'best_area_so_far': 50}, {'step': 9, 'action': 'rwz', 'area_before': 50, 'area_after': 50, 'area_reduction': 0, 'area_reduction_percent': 0.0, 'best_area_so_far': 50}, {'step': 10, 'action': 'b', 'area_before': 50, 'area_after': 50, 'area_reduction': 0, 'area_reduction_percent': 0.0, 'best_area_so_far': 50}]",10
testcase/IWLS/ex53/ex53.aag,ex53.aag,155,107,107,48,30.967741935483872,"[{'step': 1, 'action': 'b', 'area_before': 155, 'area_after': 149, 'area_reduction': 6, 'area_reduction_percent': 3.870967741935484, 'best_area_so_far': 149}, {'step': 2, 'action': 'rw', 'area_before': 149, 'area_after': 126, 'area_reduction': 23, 'area_reduction_percent': 15.436241610738255, 'best_area_so_far': 126}, {'step': 3, 'action': 'rf', 'area_before': 126, 'area_after': 113, 'area_reduction': 13, 'area_reduction_percent': 10.317460317460316, 'best_area_so_far': 113}, {'step': 4, 'action': 'b', 'area_before': 113, 'area_after': 110, 'area_reduction': 3, 'area_reduction_percent': 2.6548672566371683, 'best_area_so_far': 110}, {'step': 5, 'action': 'rw', 'area_before': 110, 'area_after': 109, 'area_reduction': 1, 'area_reduction_percent': 0.9090909090909091, 'best_area_so_far': 109}, {'step': 6, 'action': 'rwz', 'area_before': 109, 'area_after': 109, 'area_reduction': 0, 'area_reduction_percent': 0.0, 'best_area_so_far': 109}, {'step': 7, 'action': 'b', 'area_before': 109, 'area_after': 109, 'area_reduction': 0, 'area_reduction_percent': 0.0, 'best_area_so_far': 109}, {'step': 8, 'action': 'rfz', 'area_before': 109, 'area_after': 109, 'area_reduction': 0, 'area_reduction_percent': 0.0, 'best_area_so_far': 109}, {'step': 9, 'action': 'rwz', 'area_before': 109, 'area_after': 108, 'area_reduction': 1, 'area_reduction_percent': 0.9174311926605505, 'best_area_so_far': 108}, {'step': 10, 'action': 'b', 'area_before': 108, 'area_after': 107, 'area_reduction': 1, 'area_reduction_percent': 0.9259259259259258, 'best_area_so_far': 107}]",10
testcase/IWLS/ex60/ex60.aag,ex60.aag,292,225,225,67,22.945205479452056,"[{'step': 1, 'action': 'b', 'area_before': 292, 'area_after': 276, 'area_reduction': 16, 'area_reduction_percent': 5.47945205479452, 'best_area_so_far': 276}, {'step': 2, 'action': 'rw', 'area_before': 276, 'area_after': 243, 'area_reduction': 33, 'area_reduction_percent': 11.956521739130435, 'best_area_so_far': 243}, {'step': 3, 'action': 'rf', 'area_before': 243, 'area_after': 233, 'area_reduction': 10, 'area_reduction_percent': 4.11522633744856, 'best_area_so_far': 233}, {'step': 4, 'action': 'b', 'area_before': 233, 'area_after': 233, 'area_reduction': 0, 'area_reduction_percent': 0.0, 'best_area_so_far': 233}, {'step': 5, 'action': 'rw', 'area_before': 233, 'area_after': 231, 'area_reduction': 2, 'area_reduction_percent': 0.8583690987124464, 'best_area_so_far': 231}, {'step': 6, 'action': 'rwz', 'area_before': 231, 'area_after': 230, 'area_reduction': 1, 'area_reduction_percent': 0.4329004329004329, 'best_area_so_far': 230}, {'step': 7, 'action': 'b', 'area_before': 230, 'area_after': 230, 'area_reduction': 0, 'area_reduction_percent': 0.0, 'best_area_so_far': 230}, {'step': 8, 'action': 'rfz', 'area_before': 230, 'area_after': 228, 'area_reduction': 2, 'area_reduction_percent': 0.8695652173913043, 'best_area_so_far': 228}, {'step': 9, 'action': 'rwz', 'area_before': 228, 'area_after': 225, 'area_reduction': 3, 'area_reduction_percent': 1.3157894736842104, 'best_area_so_far': 225}, {'step': 10, 'action': 'b', 'area_before': 225, 'area_after': 225, 'area_reduction': 0, 'area_reduction_percent': 0.0, 'best_area_so_far': 225}]",10
testcase/IWLS/ex57/ex57.aag,ex57.aag,2277,1815,1815,462,20.28985507246377,"[{'step': 1, 'action': 'b', 'area_before': 2277, 'area_after': 2067, 'area_reduction': 210, 'area_reduction_percent': 9.22266139657444, 'best_area_so_far': 2067}, {'step': 2, 'action': 'rw', 'area_before': 2067, 'area_after': 1914, 'area_reduction': 153, 'area_reduction_percent': 7.402031930333817, 'best_area_so_far': 1914}, {'step': 3, 'action': 'rf', 'area_before': 1914, 'area_after': 1886, 'area_reduction': 28, 'area_reduction_percent': 1.4629049111807733, 'best_area_so_far': 1886}, {'step': 4, 'action': 'b', 'area_before': 1886, 'area_after': 1881, 'area_reduction': 5, 'area_reduction_percent': 0.2651113467656416, 'best_area_so_far': 1881}, {'step': 5, 'action': 'rw', 'area_before': 1881, 'area_after': 1856, 'area_reduction': 25, 'area_reduction_percent': 1.3290802764486975, 'best_area_so_far': 1856}, {'step': 6, 'action': 'rwz', 'area_before': 1856, 'area_after': 1839, 'area_reduction': 17, 'area_reduction_percent': 0.9159482758620688, 'best_area_so_far': 1839}, {'step': 7, 'action': 'b', 'area_before': 1839, 'area_after': 1838, 'area_reduction': 1, 'area_reduction_percent': 0.0543773790103317, 'best_area_so_far': 1838}, {'step': 8, 'action': 'rfz', 'area_before': 1838, 'area_after': 1829, 'area_reduction': 9, 'area_reduction_percent': 0.48966267682263326, 'best_area_so_far': 1829}, {'step': 9, 'action': 'rwz', 'area_before': 1829, 'area_after': 1815, 'area_reduction': 14, 'area_reduction_percent': 0.7654455986878075, 'best_area_so_far': 1815}, {'step': 10, 'action': 'b', 'area_before': 1815, 'area_after': 1815, 'area_reduction': 0, 'area_reduction_percent': 0.0, 'best_area_so_far': 1815}]",10
testcase/MCNC/b1/b1.aag,b1.aag,6,6,6,0,0.0,"[{'step': 1, 'action': 'b', 'area_before': 6, 'area_after': 6, 'area_reduction': 0, 'area_reduction_percent': 0.0, 'best_area_so_far': 6}, {'step': 2, 'action': 'rw', 'area_before': 6, 'area_after': 6, 'area_reduction': 0, 'area_reduction_percent': 0.0, 'best_area_so_far': 6}, {'step': 3, 'action': 'rf', 'area_before': 6, 'area_after': 6, 'area_reduction': 0, 'area_reduction_percent': 0.0, 'best_area_so_far': 6}, {'step': 4, 'action': 'b', 'area_before': 6, 'area_after': 6, 'area_reduction': 0, 'area_reduction_percent': 0.0, 'best_area_so_far': 6}, {'step': 5, 'action': 'rw', 'area_before': 6, 'area_after': 6, 'area_reduction': 0, 'area_reduction_percent': 0.0, 'best_area_so_far': 6}, {'step': 6, 'action': 'rwz', 'area_before': 6, 'area_after': 6, 'area_reduction': 0, 'area_reduction_percent': 0.0, 'best_area_so_far': 6}, {'step': 7, 'action': 'b', 'area_before': 6, 'area_after': 6, 'area_reduction': 0, 'area_reduction_percent': 0.0, 'best_area_so_far': 6}, {'step': 8, 'action': 'rfz', 'area_before': 6, 'area_after': 6, 'area_reduction': 0, 'area_reduction_percent': 0.0, 'best_area_so_far': 6}, {'step': 9, 'action': 'rwz', 'area_before': 6, 'area_after': 6, 'area_reduction': 0, 'area_reduction_percent': 0.0, 'best_area_so_far': 6}, {'step': 10, 'action': 'b', 'area_before': 6, 'area_after': 6, 'area_reduction': 0, 'area_reduction_percent': 0.0, 'best_area_so_far': 6}]",10
testcase/MCNC/C17/C17.aag,C17.aag,6,6,6,0,0.0,"[{'step': 1, 'action': 'b', 'area_before': 6, 'area_after': 6, 'area_reduction': 0, 'area_reduction_percent': 0.0, 'best_area_so_far': 6}, {'step': 2, 'action': 'rw', 'area_before': 6, 'area_after': 6, 'area_reduction': 0, 'area_reduction_percent': 0.0, 'best_area_so_far': 6}, {'step': 3, 'action': 'rf', 'area_before': 6, 'area_after': 6, 'area_reduction': 0, 'area_reduction_percent': 0.0, 'best_area_so_far': 6}, {'step': 4, 'action': 'b', 'area_before': 6, 'area_after': 6, 'area_reduction': 0, 'area_reduction_percent': 0.0, 'best_area_so_far': 6}, {'step': 5, 'action': 'rw', 'area_before': 6, 'area_after': 6, 'area_reduction': 0, 'area_reduction_percent': 0.0, 'best_area_so_far': 6}, {'step': 6, 'action': 'rwz', 'area_before': 6, 'area_after': 6, 'area_reduction': 0, 'area_reduction_percent': 0.0, 'best_area_so_far': 6}, {'step': 7, 'action': 'b', 'area_before': 6, 'area_after': 6, 'area_reduction': 0, 'area_reduction_percent': 0.0, 'best_area_so_far': 6}, {'step': 8, 'action': 'rfz', 'area_before': 6, 'area_after': 6, 'area_reduction': 0, 'area_reduction_percent': 0.0, 'best_area_so_far': 6}, {'step': 9, 'action': 'rwz', 'area_before': 6, 'area_after': 6, 'area_reduction': 0, 'area_reduction_percent': 0.0, 'best_area_so_far': 6}, {'step': 10, 'action': 'b', 'area_before': 6, 'area_after': 6, 'area_reduction': 0, 'area_reduction_percent': 0.0, 'best_area_so_far': 6}]",10
testcase/IWLS/ex119/ex119.aag,ex119.aag,51366,37595,37595,13771,26.809562745785147,"[{'step': 1, 'action': 'b', 'area_before': 51366, 'area_after': 44534, 'area_reduction': 6832, 'area_reduction_percent': 13.300626873807579, 'best_area_so_far': 44534}, {'step': 2, 'action': 'rw', 'area_before': 44534, 'area_after': 41818, 'area_reduction': 2716, 'area_reduction_percent': 6.098711097139264, 'best_area_so_far': 41818}, {'step': 3, 'action': 'rf', 'area_before': 41818, 'area_after': 39912, 'area_reduction': 1906, 'area_reduction_percent': 4.557845903677842, 'best_area_so_far': 39912}, {'step': 4, 'action': 'b', 'area_before': 39912, 'area_after': 39614, 'area_reduction': 298, 'area_reduction_percent': 0.7466426137502505, 'best_area_so_far': 39614}, {'step': 5, 'action': 'rw', 'area_before': 39614, 'area_after': 38970, 'area_reduction': 644, 'area_reduction_percent': 1.6256878881203616, 'best_area_so_far': 38970}, {'step': 6, 'action': 'rwz', 'area_before': 38970, 'area_after': 38636, 'area_reduction': 334, 'area_reduction_percent': 0.857069540672312, 'best_area_so_far': 38636}, {'step': 7, 'action': 'b', 'area_before': 38636, 'area_after': 38559, 'area_reduction': 77, 'area_reduction_percent': 0.19929599337405526, 'best_area_so_far': 38559}, {'step': 8, 'action': 'rfz', 'area_before': 38559, 'area_after': 38240, 'area_reduction': 319, 'area_reduction_percent': 0.8273036126455562, 'best_area_so_far': 38240}, {'step': 9, 'action': 'rwz', 'area_before': 38240, 'area_after': 37643, 'area_reduction': 597, 'area_reduction_percent': 1.5611924686192469, 'best_area_so_far': 37643}, {'step': 10, 'action': 'b', 'area_before': 37643, 'area_after': 37595, 'area_reduction': 48, 'area_reduction_percent': 0.12751374757591052, 'best_area_so_far': 37595}]",10
testcase/MCNC/example2/example2.aag,example2.aag,270,251,251,19,7.037037037037037,"[{'step': 1, 'action': 'b', 'area_before': 270, 'area_after': 264, 'area_reduction': 6, 'area_reduction_percent': 2.2222222222222223, 'best_area_so_far': 264}, {'step': 2, 'action': 'rw', 'area_before': 264, 'area_after': 255, 'area_reduction': 9, 'area_reduction_percent': 3.4090909090909087, 'best_area_so_far': 255}, {'step': 3, 'action': 'rf', 'area_before': 255, 'area_after': 254, 'area_reduction': 1, 'area_reduction_percent': 0.39215686274509803, 'best_area_so_far': 254}, {'step': 4, 'action': 'b', 'area_before': 254, 'area_after': 254, 'area_reduction': 0, 'area_reduction_percent': 0.0, 'best_area_so_far': 254}, {'step': 5, 'action': 'rw', 'area_before': 254, 'area_after': 253, 'area_reduction': 1, 'area_reduction_percent': 0.39370078740157477, 'best_area_so_far': 253}, {'step': 6, 'action': 'rwz', 'area_before': 253, 'area_after': 253, 'area_reduction': 0, 'area_reduction_percent': 0.0, 'best_area_so_far': 253}, {'step': 7, 'action': 'b', 'area_before': 253, 'area_after': 253, 'area_reduction': 0, 'area_reduction_percent': 0.0, 'best_area_so_far': 253}, {'step': 8, 'action': 'rfz', 'area_before': 253, 'area_after': 253, 'area_reduction': 0, 'area_reduction_percent': 0.0, 'best_area_so_far': 253}, {'step': 9, 'action': 'rwz', 'area_before': 253, 'area_after': 251, 'area_reduction': 2, 'area_reduction_percent': 0.7905138339920948, 'best_area_so_far': 251}, {'step': 10, 'action': 'b', 'area_before': 251, 'area_after': 251, 'area_reduction': 0, 'area_reduction_percent': 0.0, 'best_area_so_far': 251}]",10
testcase/MCNC/pcler8/pcler8.aag,pcler8.aag,71,65,65,6,8.450704225352112,"[{'step': 1, 'action': 'b', 'area_before': 71, 'area_after': 71, 'area_reduction': 0, 'area_reduction_percent': 0.0, 'best_area_so_far': 71}, {'step': 2, 'action': 'rw', 'area_before': 71, 'area_after': 68, 'area_reduction': 3, 'area_reduction_percent': 4.225352112676056, 'best_area_so_far': 68}, {'step': 3, 'action': 'rf', 'area_before': 68, 'area_after': 67, 'area_reduction': 1, 'area_reduction_percent': 1.4705882352941175, 'best_area_so_far': 67}, {'step': 4, 'action': 'b', 'area_before': 67, 'area_after': 67, 'area_reduction': 0, 'area_reduction_percent': 0.0, 'best_area_so_far': 67}, {'step': 5, 'action': 'rw', 'area_before': 67, 'area_after': 66, 'area_reduction': 1, 'area_reduction_percent': 1.4925373134328357, 'best_area_so_far': 66}, {'step': 6, 'action': 'rwz', 'area_before': 66, 'area_after': 65, 'area_reduction': 1, 'area_reduction_percent': 1.5151515151515151, 'best_area_so_far': 65}, {'step': 7, 'action': 'b', 'area_before': 65, 'area_after': 65, 'area_reduction': 0, 'area_reduction_percent': 0.0, 'best_area_so_far': 65}, {'step': 8, 'action': 'rfz', 'area_before': 65, 'area_after': 65, 'area_reduction': 0, 'area_reduction_percent': 0.0, 'best_area_so_far': 65}, {'step': 9, 'action': 'rwz', 'area_before': 65, 'area_after': 65, 'area_reduction': 0, 'area_reduction_percent': 0.0, 'best_area_so_far': 65}, {'step': 10, 'action': 'b', 'area_before': 65, 'area_after': 65, 'area_reduction': 0, 'area_reduction_percent': 0.0, 'best_area_so_far': 65}]",10
testcase/MCNC/C5315/C5315.aag,C5315.aag,1595,1339,1339,256,16.050156739811914,"[{'step': 1, 'action': 'b', 'area_before': 1595, 'area_after': 1595, 'area_reduction': 0, 'area_reduction_percent': 0.0, 'best_area_so_far': 1595}, {'step': 2, 'action': 'rw', 'area_before': 1595, 'area_after': 1479, 'area_reduction': 116, 'area_reduction_percent': 7.2727272727272725, 'best_area_so_far': 1479}, {'step': 3, 'action': 'rf', 'area_before': 1479, 'area_after': 1390, 'area_reduction': 89, 'area_reduction_percent': 6.017579445571332, 'best_area_so_far': 1390}, {'step': 4, 'action': 'b', 'area_before': 1390, 'area_after': 1389, 'area_reduction': 1, 'area_reduction_percent': 0.07194244604316546, 'best_area_so_far': 1389}, {'step': 5, 'action': 'rw', 'area_before': 1389, 'area_after': 1377, 'area_reduction': 12, 'area_reduction_percent': 0.8639308855291578, 'best_area_so_far': 1377}, {'step': 6, 'action': 'rwz', 'area_before': 1377, 'area_after': 1366, 'area_reduction': 11, 'area_reduction_percent': 0.7988380537400145, 'best_area_so_far': 1366}, {'step': 7, 'action': 'b', 'area_before': 1366, 'area_after': 1366, 'area_reduction': 0, 'area_reduction_percent': 0.0, 'best_area_so_far': 1366}, {'step': 8, 'action': 'rfz', 'area_before': 1366, 'area_after': 1347, 'area_reduction': 19, 'area_reduction_percent': 1.390922401171303, 'best_area_so_far': 1347}, {'step': 9, 'action': 'rwz', 'area_before': 1347, 'area_after': 1339, 'area_reduction': 8, 'area_reduction_percent': 0.5939123979213066, 'best_area_so_far': 1339}, {'step': 10, 'action': 'b', 'area_before': 1339, 'area_after': 1339, 'area_reduction': 0, 'area_reduction_percent': 0.0, 'best_area_so_far': 1339}]",10
testcase/MCNC/C1355/C1355.aag,C1355.aag,590,386,386,204,34.57627118644068,"[{'step': 1, 'action': 'b', 'area_before': 590, 'area_after': 590, 'area_reduction': 0, 'area_reduction_percent': 0.0, 'best_area_so_far': 590}, {'step': 2, 'action': 'rw', 'area_before': 590, 'area_after': 581, 'area_reduction': 9, 'area_reduction_percent': 1.5254237288135595, 'best_area_so_far': 581}, {'step': 3, 'action': 'rf', 'area_before': 581, 'area_after': 386, 'area_reduction': 195, 'area_reduction_percent': 33.56282271944922, 'best_area_so_far': 386}, {'step': 4, 'action': 'b', 'area_before': 386, 'area_after': 386, 'area_reduction': 0, 'area_reduction_percent': 0.0, 'best_area_so_far': 386}, {'step': 5, 'action': 'rw', 'area_before': 386, 'area_after': 386, 'area_reduction': 0, 'area_reduction_percent': 0.0, 'best_area_so_far': 386}, {'step': 6, 'action': 'rwz', 'area_before': 386, 'area_after': 386, 'area_reduction': 0, 'area_reduction_percent': 0.0, 'best_area_so_far': 386}, {'step': 7, 'action': 'b', 'area_before': 386, 'area_after': 386, 'area_reduction': 0, 'area_reduction_percent': 0.0, 'best_area_so_far': 386}, {'step': 8, 'action': 'rfz', 'area_before': 386, 'area_after': 386, 'area_reduction': 0, 'area_reduction_percent': 0.0, 'best_area_so_far': 386}, {'step': 9, 'action': 'rwz', 'area_before': 386, 'area_after': 386, 'area_reduction': 0, 'area_reduction_percent': 0.0, 'best_area_so_far': 386}, {'step': 10, 'action': 'b', 'area_before': 386, 'area_after': 386, 'area_reduction': 0, 'area_reduction_percent': 0.0, 'best_area_so_far': 386}]",10
testcase/MCNC/table5/table5.aag,table5.aag,1987,1468,1468,519,26.119778560644185,"[{'step': 1, 'action': 'b', 'area_before': 1987, 'area_after': 1655, 'area_reduction': 332, 'area_reduction_percent': 16.708605938600908, 'best_area_so_far': 1655}, {'step': 2, 'action': 'rw', 'area_before': 1655, 'area_after': 1533, 'area_reduction': 122, 'area_reduction_percent': 7.371601208459215, 'best_area_so_far': 1533}, {'step': 3, 'action': 'rf', 'area_before': 1533, 'area_after': 1528, 'area_reduction': 5, 'area_reduction_percent': 0.32615786040443573, 'best_area_so_far': 1528}, {'step': 4, 'action': 'b', 'area_before': 1528, 'area_after': 1525, 'area_reduction': 3, 'area_reduction_percent': 0.1963350785340314, 'best_area_so_far': 1525}, {'step': 5, 'action': 'rw', 'area_before': 1525, 'area_after': 1511, 'area_reduction': 14, 'area_reduction_percent': 0.9180327868852459, 'best_area_so_far': 1511}, {'step': 6, 'action': 'rwz', 'area_before': 1511, 'area_after': 1497, 'area_reduction': 14, 'area_reduction_percent': 0.9265387160820648, 'best_area_so_far': 1497}, {'step': 7, 'action': 'b', 'area_before': 1497, 'area_after': 1493, 'area_reduction': 4, 'area_reduction_percent': 0.26720106880427524, 'best_area_so_far': 1493}, {'step': 8, 'action': 'rfz', 'area_before': 1493, 'area_after': 1492, 'area_reduction': 1, 'area_reduction_percent': 0.06697923643670461, 'best_area_so_far': 1492}, {'step': 9, 'action': 'rwz', 'area_before': 1492, 'area_after': 1473, 'area_reduction': 19, 'area_reduction_percent': 1.2734584450402144, 'best_area_so_far': 1473}, {'step': 10, 'action': 'b', 'area_before': 1473, 'area_after': 1468, 'area_reduction': 5, 'area_reduction_percent': 0.3394433129667346, 'best_area_so_far': 1468}]",10
testcase/IWLS/ex171/ex171.aag,ex171.aag,8884,6748,6748,2136,24.04322377307519,"[{'step': 1, 'action': 'b', 'area_before': 8884, 'area_after': 7680, 'area_reduction': 1204, 'area_reduction_percent': 13.55245384961729, 'best_area_so_far': 7680}, {'step': 2, 'action': 'rw', 'area_before': 7680, 'area_after': 7229, 'area_reduction': 451, 'area_reduction_percent': 5.872395833333333, 'best_area_so_far': 7229}, {'step': 3, 'action': 'rf', 'area_before': 7229, 'area_after': 7047, 'area_reduction': 182, 'area_reduction_percent': 2.5176372942315672, 'best_area_so_far': 7047}, {'step': 4, 'action': 'b', 'area_before': 7047, 'area_after': 7011, 'area_reduction': 36, 'area_reduction_percent': 0.5108556832694764, 'best_area_so_far': 7011}, {'step': 5, 'action': 'rw', 'area_before': 7011, 'area_after': 6938, 'area_reduction': 73, 'area_reduction_percent': 1.0412209385251747, 'best_area_so_far': 6938}, {'step': 6, 'action': 'rwz', 'area_before': 6938, 'area_after': 6882, 'area_reduction': 56, 'area_reduction_percent': 0.807149034303834, 'best_area_so_far': 6882}, {'step': 7, 'action': 'b', 'area_before': 6882, 'area_after': 6873, 'area_reduction': 9, 'area_reduction_percent': 0.13077593722755013, 'best_area_so_far': 6873}, {'step': 8, 'action': 'rfz', 'area_before': 6873, 'area_after': 6841, 'area_reduction': 32, 'area_reduction_percent': 0.46558998981521893, 'best_area_so_far': 6841}, {'step': 9, 'action': 'rwz', 'area_before': 6841, 'area_after': 6753, 'area_reduction': 88, 'area_reduction_percent': 1.286361643034644, 'best_area_so_far': 6753}, {'step': 10, 'action': 'b', 'area_before': 6753, 'area_after': 6748, 'area_reduction': 5, 'area_reduction_percent': 0.07404116688879016, 'best_area_so_far': 6748}]",10
testcase/MCNC/prom1/prom1.aag,prom1.aag,3316,3286,3286,30,0.9047044632086853,"[{'step': 1, 'action': 'b', 'area_before': 3316, 'area_after': 3314, 'area_reduction': 2, 'area_reduction_percent': 0.060313630880579006, 'best_area_so_far': 3314}, {'step': 2, 'action': 'rw', 'area_before': 3314, 'area_after': 3305, 'area_reduction': 9, 'area_reduction_percent': 0.27157513578756787, 'best_area_so_far': 3305}, {'step': 3, 'action': 'rf', 'area_before': 3305, 'area_after': 3303, 'area_reduction': 2, 'area_reduction_percent': 0.0605143721633888, 'best_area_so_far': 3303}, {'step': 4, 'action': 'b', 'area_before': 3303, 'area_after': 3303, 'area_reduction': 0, 'area_reduction_percent': 0.0, 'best_area_so_far': 3303}, {'step': 5, 'action': 'rw', 'area_before': 3303, 'area_after': 3302, 'area_reduction': 1, 'area_reduction_percent': 0.030275507114744173, 'best_area_so_far': 3302}, {'step': 6, 'action': 'rwz', 'area_before': 3302, 'area_after': 3298, 'area_reduction': 4, 'area_reduction_percent': 0.12113870381586916, 'best_area_so_far': 3298}, {'step': 7, 'action': 'b', 'area_before': 3298, 'area_after': 3296, 'area_reduction': 2, 'area_reduction_percent': 0.06064281382656155, 'best_area_so_far': 3296}, {'step': 8, 'action': 'rfz', 'area_before': 3296, 'area_after': 3296, 'area_reduction': 0, 'area_reduction_percent': 0.0, 'best_area_so_far': 3296}, {'step': 9, 'action': 'rwz', 'area_before': 3296, 'area_after': 3288, 'area_reduction': 8, 'area_reduction_percent': 0.24271844660194172, 'best_area_so_far': 3288}, {'step': 10, 'action': 'b', 'area_before': 3288, 'area_after': 3286, 'area_reduction': 2, 'area_reduction_percent': 0.06082725060827251, 'best_area_so_far': 3286}]",10
testcase/MCNC/m3/m3.aag,m3.aag,306,300,300,6,1.9607843137254901,"[{'step': 1, 'action': 'b', 'area_before': 306, 'area_after': 306, 'area_reduction': 0, 'area_reduction_percent': 0.0, 'best_area_so_far': 306}, {'step': 2, 'action': 'rw', 'area_before': 306, 'area_after': 306, 'area_reduction': 0, 'area_reduction_percent': 0.0, 'best_area_so_far': 306}, {'step': 3, 'action': 'rf', 'area_before': 306, 'area_after': 304, 'area_reduction': 2, 'area_reduction_percent': 0.6535947712418301, 'best_area_so_far': 304}, {'step': 4, 'action': 'b', 'area_before': 304, 'area_after': 304, 'area_reduction': 0, 'area_reduction_percent': 0.0, 'best_area_so_far': 304}, {'step': 5, 'action': 'rw', 'area_before': 304, 'area_after': 304, 'area_reduction': 0, 'area_reduction_percent': 0.0, 'best_area_so_far': 304}, {'step': 6, 'action': 'rwz', 'area_before': 304, 'area_after': 303, 'area_reduction': 1, 'area_reduction_percent': 0.3289473684210526, 'best_area_so_far': 303}, {'step': 7, 'action': 'b', 'area_before': 303, 'area_after': 303, 'area_reduction': 0, 'area_reduction_percent': 0.0, 'best_area_so_far': 303}, {'step': 8, 'action': 'rfz', 'area_before': 303, 'area_after': 302, 'area_reduction': 1, 'area_reduction_percent': 0.33003300330033003, 'best_area_so_far': 302}, {'step': 9, 'action': 'rwz', 'area_before': 302, 'area_after': 300, 'area_reduction': 2, 'area_reduction_percent': 0.6622516556291391, 'best_area_so_far': 300}, {'step': 10, 'action': 'b', 'area_before': 300, 'area_after': 300, 'area_reduction': 0, 'area_reduction_percent': 0.0, 'best_area_so_far': 300}]",10
testcase/IWLS/ex96/ex96.aag,ex96.aag,339,246,246,93,27.43362831858407,"[{'step': 1, 'action': 'b', 'area_before': 339, 'area_after': 322, 'area_reduction': 17, 'area_reduction_percent': 5.014749262536873, 'best_area_so_far': 322}, {'step': 2, 'action': 'rw', 'area_before': 322, 'area_after': 285, 'area_reduction': 37, 'area_reduction_percent': 11.490683229813664, 'best_area_so_far': 285}, {'step': 3, 'action': 'rf', 'area_before': 285, 'area_after': 267, 'area_reduction': 18, 'area_reduction_percent': 6.315789473684211, 'best_area_so_far': 267}, {'step': 4, 'action': 'b', 'area_before': 267, 'area_after': 266, 'area_reduction': 1, 'area_reduction_percent': 0.37453183520599254, 'best_area_so_far': 266}, {'step': 5, 'action': 'rw', 'area_before': 266, 'area_after': 259, 'area_reduction': 7, 'area_reduction_percent': 2.631578947368421, 'best_area_so_far': 259}, {'step': 6, 'action': 'rwz', 'area_before': 259, 'area_after': 257, 'area_reduction': 2, 'area_reduction_percent': 0.7722007722007722, 'best_area_so_far': 257}, {'step': 7, 'action': 'b', 'area_before': 257, 'area_after': 257, 'area_reduction': 0, 'area_reduction_percent': 0.0, 'best_area_so_far': 257}, {'step': 8, 'action': 'rfz', 'area_before': 257, 'area_after': 255, 'area_reduction': 2, 'area_reduction_percent': 0.7782101167315175, 'best_area_so_far': 255}, {'step': 9, 'action': 'rwz', 'area_before': 255, 'area_after': 248, 'area_reduction': 7, 'area_reduction_percent': 2.7450980392156863, 'best_area_so_far': 248}, {'step': 10, 'action': 'b', 'area_before': 248, 'area_after': 246, 'area_reduction': 2, 'area_reduction_percent': 0.8064516129032258, 'best_area_so_far': 246}]",10
testcase/MCNC/tcon/tcon.aag,tcon.aag,24,24,24,0,0.0,"[{'step': 1, 'action': 'b', 'area_before': 24, 'area_after': 24, 'area_reduction': 0, 'area_reduction_percent': 0.0, 'best_area_so_far': 24}, {'step': 2, 'action': 'rw', 'area_before': 24, 'area_after': 24, 'area_reduction': 0, 'area_reduction_percent': 0.0, 'best_area_so_far': 24}, {'step': 3, 'action': 'rf', 'area_before': 24, 'area_after': 24, 'area_reduction': 0, 'area_reduction_percent': 0.0, 'best_area_so_far': 24}, {'step': 4, 'action': 'b', 'area_before': 24, 'area_after': 24, 'area_reduction': 0, 'area_reduction_percent': 0.0, 'best_area_so_far': 24}, {'step': 5, 'action': 'rw', 'area_before': 24, 'area_after': 24, 'area_reduction': 0, 'area_reduction_percent': 0.0, 'best_area_so_far': 24}, {'step': 6, 'action': 'rwz', 'area_before': 24, 'area_after': 24, 'area_reduction': 0, 'area_reduction_percent': 0.0, 'best_area_so_far': 24}, {'step': 7, 'action': 'b', 'area_before': 24, 'area_after': 24, 'area_reduction': 0, 'area_reduction_percent': 0.0, 'best_area_so_far': 24}, {'step': 8, 'action': 'rfz', 'area_before': 24, 'area_after': 24, 'area_reduction': 0, 'area_reduction_percent': 0.0, 'best_area_so_far': 24}, {'step': 9, 'action': 'rwz', 'area_before': 24, 'area_after': 24, 'area_reduction': 0, 'area_reduction_percent': 0.0, 'best_area_so_far': 24}, {'step': 10, 'action': 'b', 'area_before': 24, 'area_after': 24, 'area_reduction': 0, 'area_reduction_percent': 0.0, 'best_area_so_far': 24}]",10
testcase/IWLS/ex90/ex90.aag,ex90.aag,2909,2348,2348,561,19.284977655551735,"[{'step': 1, 'action': 'b', 'area_before': 2909, 'area_after': 2700, 'area_reduction': 209, 'area_reduction_percent': 7.18459951873496, 'best_area_so_far': 2700}, {'step': 2, 'action': 'rw', 'area_before': 2700, 'area_after': 2511, 'area_reduction': 189, 'area_reduction_percent': 7.000000000000001, 'best_area_so_far': 2511}, {'step': 3, 'action': 'rf', 'area_before': 2511, 'area_after': 2448, 'area_reduction': 63, 'area_reduction_percent': 2.5089605734767026, 'best_area_so_far': 2448}, {'step': 4, 'action': 'b', 'area_before': 2448, 'area_after': 2440, 'area_reduction': 8, 'area_reduction_percent': 0.32679738562091504, 'best_area_so_far': 2440}, {'step': 5, 'action': 'rw', 'area_before': 2440, 'area_after': 2407, 'area_reduction': 33, 'area_reduction_percent': 1.3524590163934427, 'best_area_so_far': 2407}, {'step': 6, 'action': 'rwz', 'area_before': 2407, 'area_after': 2389, 'area_reduction': 18, 'area_reduction_percent': 0.7478188616535106, 'best_area_so_far': 2389}, {'step': 7, 'action': 'b', 'area_before': 2389, 'area_after': 2384, 'area_reduction': 5, 'area_reduction_percent': 0.2092925910422771, 'best_area_so_far': 2384}, {'step': 8, 'action': 'rfz', 'area_before': 2384, 'area_after': 2380, 'area_reduction': 4, 'area_reduction_percent': 0.16778523489932887, 'best_area_so_far': 2380}, {'step': 9, 'action': 'rwz', 'area_before': 2380, 'area_after': 2349, 'area_reduction': 31, 'area_reduction_percent': 1.3025210084033614, 'best_area_so_far': 2349}, {'step': 10, 'action': 'b', 'area_before': 2349, 'area_after': 2348, 'area_reduction': 1, 'area_reduction_percent': 0.04257130693912303, 'best_area_so_far': 2348}]",10
testcase/IWLS/ex130/ex130.aag,ex130.aag,142,86,86,56,39.436619718309856,"[{'step': 1, 'action': 'b', 'area_before': 142, 'area_after': 139, 'area_reduction': 3, 'area_reduction_percent': 2.112676056338028, 'best_area_so_far': 139}, {'step': 2, 'action': 'rw', 'area_before': 139, 'area_after': 116, 'area_reduction': 23, 'area_reduction_percent': 16.546762589928058, 'best_area_so_far': 116}, {'step': 3, 'action': 'rf', 'area_before': 116, 'area_after': 95, 'area_reduction': 21, 'area_reduction_percent': 18.103448275862068, 'best_area_so_far': 95}, {'step': 4, 'action': 'b', 'area_before': 95, 'area_after': 92, 'area_reduction': 3, 'area_reduction_percent': 3.1578947368421053, 'best_area_so_far': 92}, {'step': 5, 'action': 'rw', 'area_before': 92, 'area_after': 90, 'area_reduction': 2, 'area_reduction_percent': 2.1739130434782608, 'best_area_so_far': 90}, {'step': 6, 'action': 'rwz', 'area_before': 90, 'area_after': 89, 'area_reduction': 1, 'area_reduction_percent': 1.1111111111111112, 'best_area_so_far': 89}, {'step': 7, 'action': 'b', 'area_before': 89, 'area_after': 89, 'area_reduction': 0, 'area_reduction_percent': 0.0, 'best_area_so_far': 89}, {'step': 8, 'action': 'rfz', 'area_before': 89, 'area_after': 89, 'area_reduction': 0, 'area_reduction_percent': 0.0, 'best_area_so_far': 89}, {'step': 9, 'action': 'rwz', 'area_before': 89, 'area_after': 87, 'area_reduction': 2, 'area_reduction_percent': 2.247191011235955, 'best_area_so_far': 87}, {'step': 10, 'action': 'b', 'area_before': 87, 'area_after': 86, 'area_reduction': 1, 'area_reduction_percent': 1.1494252873563218, 'best_area_so_far': 86}]",10
testcase/IWLS/ex83/ex83.aag,ex83.aag,4181,3383,3383,798,19.08634298014829,"[{'step': 1, 'action': 'b', 'area_before': 4181, 'area_after': 3825, 'area_reduction': 356, 'area_reduction_percent': 8.514709399665152, 'best_area_so_far': 3825}, {'step': 2, 'action': 'rw', 'area_before': 3825, 'area_after': 3588, 'area_reduction': 237, 'area_reduction_percent': 6.196078431372549, 'best_area_so_far': 3588}, {'step': 3, 'action': 'rf', 'area_before': 3588, 'area_after': 3521, 'area_reduction': 67, 'area_reduction_percent': 1.8673355629877368, 'best_area_so_far': 3521}, {'step': 4, 'action': 'b', 'area_before': 3521, 'area_after': 3512, 'area_reduction': 9, 'area_reduction_percent': 0.2556092019312695, 'best_area_so_far': 3512}, {'step': 5, 'action': 'rw', 'area_before': 3512, 'area_after': 3472, 'area_reduction': 40, 'area_reduction_percent': 1.1389521640091116, 'best_area_so_far': 3472}, {'step': 6, 'action': 'rwz', 'area_before': 3472, 'area_after': 3450, 'area_reduction': 22, 'area_reduction_percent': 0.6336405529953917, 'best_area_so_far': 3450}, {'step': 7, 'action': 'b', 'area_before': 3450, 'area_after': 3445, 'area_reduction': 5, 'area_reduction_percent': 0.14492753623188406, 'best_area_so_far': 3445}, {'step': 8, 'action': 'rfz', 'area_before': 3445, 'area_after': 3433, 'area_reduction': 12, 'area_reduction_percent': 0.3483309143686502, 'best_area_so_far': 3433}, {'step': 9, 'action': 'rwz', 'area_before': 3433, 'area_after': 3390, 'area_reduction': 43, 'area_reduction_percent': 1.2525487911447712, 'best_area_so_far': 3390}, {'step': 10, 'action': 'b', 'area_before': 3390, 'area_after': 3383, 'area_reduction': 7, 'area_reduction_percent': 0.20648967551622419, 'best_area_so_far': 3383}]",10
testcase/IWLS/ex189/ex189.aag,ex189.aag,76282,61145,61145,15137,19.843475525025564,"[{'step': 1, 'action': 'b', 'area_before': 76282, 'area_after': 66689, 'area_reduction': 9593, 'area_reduction_percent': 12.575705933247686, 'best_area_so_far': 66689}, {'step': 2, 'action': 'rw', 'area_before': 66689, 'area_after': 63995, 'area_reduction': 2694, 'area_reduction_percent': 4.039646718349353, 'best_area_so_far': 63995}, {'step': 3, 'action': 'rf', 'area_before': 63995, 'area_after': 63083, 'area_reduction': 912, 'area_reduction_percent': 1.4251113368231894, 'best_area_so_far': 63083}, {'step': 4, 'action': 'b', 'area_before': 63083, 'area_after': 62953, 'area_reduction': 130, 'area_reduction_percent': 0.206077707147726, 'best_area_so_far': 62953}, {'step': 5, 'action': 'rw', 'area_before': 62953, 'area_after': 62379, 'area_reduction': 574, 'area_reduction_percent': 0.9117913363938177, 'best_area_so_far': 62379}, {'step': 6, 'action': 'rwz', 'area_before': 62379, 'area_after': 61970, 'area_reduction': 409, 'area_reduction_percent': 0.6556693759117652, 'best_area_so_far': 61970}, {'step': 7, 'action': 'b', 'area_before': 61970, 'area_after': 61883, 'area_reduction': 87, 'area_reduction_percent': 0.14039051153784088, 'best_area_so_far': 61883}, {'step': 8, 'action': 'rfz', 'area_before': 61883, 'area_after': 61771, 'area_reduction': 112, 'area_reduction_percent': 0.18098670070940323, 'best_area_so_far': 61771}, {'step': 9, 'action': 'rwz', 'area_before': 61771, 'area_after': 61191, 'area_reduction': 580, 'area_reduction_percent': 0.9389519353742046, 'best_area_so_far': 61191}, {'step': 10, 'action': 'b', 'area_before': 61191, 'area_after': 61145, 'area_reduction': 46, 'area_reduction_percent': 0.07517445375953981, 'best_area_so_far': 61145}]",10
testcase/IWLS/ex81/ex81.aag,ex81.aag,2409,1845,1845,564,23.41220423412204,"[{'step': 1, 'action': 'b', 'area_before': 2409, 'area_after': 2206, 'area_reduction': 203, 'area_reduction_percent': 8.426733084267331, 'best_area_so_far': 2206}, {'step': 2, 'action': 'rw', 'area_before': 2206, 'area_after': 2038, 'area_reduction': 168, 'area_reduction_percent': 7.615593834995467, 'best_area_so_far': 2038}, {'step': 3, 'action': 'rf', 'area_before': 2038, 'area_after': 1954, 'area_reduction': 84, 'area_reduction_percent': 4.121687929342492, 'best_area_so_far': 1954}, {'step': 4, 'action': 'b', 'area_before': 1954, 'area_after': 1941, 'area_reduction': 13, 'area_reduction_percent': 0.6653019447287616, 'best_area_so_far': 1941}, {'step': 5, 'action': 'rw', 'area_before': 1941, 'area_after': 1917, 'area_reduction': 24, 'area_reduction_percent': 1.2364760432766615, 'best_area_so_far': 1917}, {'step': 6, 'action': 'rwz', 'area_before': 1917, 'area_after': 1900, 'area_reduction': 17, 'area_reduction_percent': 0.8868022952529996, 'best_area_so_far': 1900}, {'step': 7, 'action': 'b', 'area_before': 1900, 'area_after': 1894, 'area_reduction': 6, 'area_reduction_percent': 0.3157894736842105, 'best_area_so_far': 1894}, {'step': 8, 'action': 'rfz', 'area_before': 1894, 'area_after': 1886, 'area_reduction': 8, 'area_reduction_percent': 0.42238648363252373, 'best_area_so_far': 1886}, {'step': 9, 'action': 'rwz', 'area_before': 1886, 'area_after': 1847, 'area_reduction': 39, 'area_reduction_percent': 2.067868504772004, 'best_area_so_far': 1847}, {'step': 10, 'action': 'b', 'area_before': 1847, 'area_after': 1845, 'area_reduction': 2, 'area_reduction_percent': 0.10828370330265295, 'best_area_so_far': 1845}]",10
testcase/IWLS/ex36/ex36.aag,ex36.aag,3052,2521,2521,531,17.398427260812582,"[{'step': 1, 'action': 'b', 'area_before': 3052, 'area_after': 2768, 'area_reduction': 284, 'area_reduction_percent': 9.305373525557012, 'best_area_so_far': 2768}, {'step': 2, 'action': 'rw', 'area_before': 2768, 'area_after': 2595, 'area_reduction': 173, 'area_reduction_percent': 6.25, 'best_area_so_far': 2595}, {'step': 3, 'action': 'rf', 'area_before': 2595, 'area_after': 2581, 'area_reduction': 14, 'area_reduction_percent': 0.5394990366088632, 'best_area_so_far': 2581}, {'step': 4, 'action': 'b', 'area_before': 2581, 'area_after': 2576, 'area_reduction': 5, 'area_reduction_percent': 0.19372336303758234, 'best_area_so_far': 2576}, {'step': 5, 'action': 'rw', 'area_before': 2576, 'area_after': 2565, 'area_reduction': 11, 'area_reduction_percent': 0.42701863354037267, 'best_area_so_far': 2565}, {'step': 6, 'action': 'rwz', 'area_before': 2565, 'area_after': 2542, 'area_reduction': 23, 'area_reduction_percent': 0.8966861598440545, 'best_area_so_far': 2542}, {'step': 7, 'action': 'b', 'area_before': 2542, 'area_after': 2540, 'area_reduction': 2, 'area_reduction_percent': 0.07867820613690008, 'best_area_so_far': 2540}, {'step': 8, 'action': 'rfz', 'area_before': 2540, 'area_after': 2538, 'area_reduction': 2, 'area_reduction_percent': 0.07874015748031496, 'best_area_so_far': 2538}, {'step': 9, 'action': 'rwz', 'area_before': 2538, 'area_after': 2523, 'area_reduction': 15, 'area_reduction_percent': 0.5910165484633569, 'best_area_so_far': 2523}, {'step': 10, 'action': 'b', 'area_before': 2523, 'area_after': 2521, 'area_reduction': 2, 'area_reduction_percent': 0.07927070947284978, 'best_area_so_far': 2521}]",10
testcase/MCNC/m2/m2.aag,m2.aag,240,236,236,4,1.6666666666666667,"[{'step': 1, 'action': 'b', 'area_before': 240, 'area_after': 240, 'area_reduction': 0, 'area_reduction_percent': 0.0, 'best_area_so_far': 240}, {'step': 2, 'action': 'rw', 'area_before': 240, 'area_after': 240, 'area_reduction': 0, 'area_reduction_percent': 0.0, 'best_area_so_far': 240}, {'step': 3, 'action': 'rf', 'area_before': 240, 'area_after': 240, 'area_reduction': 0, 'area_reduction_percent': 0.0, 'best_area_so_far': 240}, {'step': 4, 'action': 'b', 'area_before': 240, 'area_after': 240, 'area_reduction': 0, 'area_reduction_percent': 0.0, 'best_area_so_far': 240}, {'step': 5, 'action': 'rw', 'area_before': 240, 'area_after': 240, 'area_reduction': 0, 'area_reduction_percent': 0.0, 'best_area_so_far': 240}, {'step': 6, 'action': 'rwz', 'area_before': 240, 'area_after': 240, 'area_reduction': 0, 'area_reduction_percent': 0.0, 'best_area_so_far': 240}, {'step': 7, 'action': 'b', 'area_before': 240, 'area_after': 240, 'area_reduction': 0, 'area_reduction_percent': 0.0, 'best_area_so_far': 240}, {'step': 8, 'action': 'rfz', 'area_before': 240, 'area_after': 240, 'area_reduction': 0, 'area_reduction_percent': 0.0, 'best_area_so_far': 240}, {'step': 9, 'action': 'rwz', 'area_before': 240, 'area_after': 236, 'area_reduction': 4, 'area_reduction_percent': 1.6666666666666667, 'best_area_so_far': 236}, {'step': 10, 'action': 'b', 'area_before': 236, 'area_after': 236, 'area_reduction': 0, 'area_reduction_percent': 0.0, 'best_area_so_far': 236}]",10
testcase/MCNC/b3/b3.aag,b3.aag,524,323,323,201,38.3587786259542,"[{'step': 1, 'action': 'b', 'area_before': 524, 'area_after': 440, 'area_reduction': 84, 'area_reduction_percent': 16.030534351145036, 'best_area_so_far': 440}, {'step': 2, 'action': 'rw', 'area_before': 440, 'area_after': 389, 'area_reduction': 51, 'area_reduction_percent': 11.59090909090909, 'best_area_so_far': 389}, {'step': 3, 'action': 'rf', 'area_before': 389, 'area_after': 370, 'area_reduction': 19, 'area_reduction_percent': 4.884318766066838, 'best_area_so_far': 370}, {'step': 4, 'action': 'b', 'area_before': 370, 'area_after': 363, 'area_reduction': 7, 'area_reduction_percent': 1.891891891891892, 'best_area_so_far': 363}, {'step': 5, 'action': 'rw', 'area_before': 363, 'area_after': 355, 'area_reduction': 8, 'area_reduction_percent': 2.203856749311295, 'best_area_so_far': 355}, {'step': 6, 'action': 'rwz', 'area_before': 355, 'area_after': 343, 'area_reduction': 12, 'area_reduction_percent': 3.3802816901408446, 'best_area_so_far': 343}, {'step': 7, 'action': 'b', 'area_before': 343, 'area_after': 340, 'area_reduction': 3, 'area_reduction_percent': 0.8746355685131195, 'best_area_so_far': 340}, {'step': 8, 'action': 'rfz', 'area_before': 340, 'area_after': 338, 'area_reduction': 2, 'area_reduction_percent': 0.5882352941176471, 'best_area_so_far': 338}, {'step': 9, 'action': 'rwz', 'area_before': 338, 'area_after': 326, 'area_reduction': 12, 'area_reduction_percent': 3.5502958579881656, 'best_area_so_far': 326}, {'step': 10, 'action': 'b', 'area_before': 326, 'area_after': 323, 'area_reduction': 3, 'area_reduction_percent': 0.9202453987730062, 'best_area_so_far': 323}]",10
testcase/MCNC/unreg/unreg.aag,unreg.aag,97,97,97,0,0.0,"[{'step': 1, 'action': 'b', 'area_before': 97, 'area_after': 97, 'area_reduction': 0, 'area_reduction_percent': 0.0, 'best_area_so_far': 97}, {'step': 2, 'action': 'rw', 'area_before': 97, 'area_after': 97, 'area_reduction': 0, 'area_reduction_percent': 0.0, 'best_area_so_far': 97}, {'step': 3, 'action': 'rf', 'area_before': 97, 'area_after': 97, 'area_reduction': 0, 'area_reduction_percent': 0.0, 'best_area_so_far': 97}, {'step': 4, 'action': 'b', 'area_before': 97, 'area_after': 97, 'area_reduction': 0, 'area_reduction_percent': 0.0, 'best_area_so_far': 97}, {'step': 5, 'action': 'rw', 'area_before': 97, 'area_after': 97, 'area_reduction': 0, 'area_reduction_percent': 0.0, 'best_area_so_far': 97}, {'step': 6, 'action': 'rwz', 'area_before': 97, 'area_after': 97, 'area_reduction': 0, 'area_reduction_percent': 0.0, 'best_area_so_far': 97}, {'step': 7, 'action': 'b', 'area_before': 97, 'area_after': 97, 'area_reduction': 0, 'area_reduction_percent': 0.0, 'best_area_so_far': 97}, {'step': 8, 'action': 'rfz', 'area_before': 97, 'area_after': 97, 'area_reduction': 0, 'area_reduction_percent': 0.0, 'best_area_so_far': 97}, {'step': 9, 'action': 'rwz', 'area_before': 97, 'area_after': 97, 'area_reduction': 0, 'area_reduction_percent': 0.0, 'best_area_so_far': 97}, {'step': 10, 'action': 'b', 'area_before': 97, 'area_after': 97, 'area_reduction': 0, 'area_reduction_percent': 0.0, 'best_area_so_far': 97}]",10
testcase/MCNC/apex5/apex5.aag,apex5.aag,1280,819,819,461,36.015625,"[{'step': 1, 'action': 'b', 'area_before': 1280, 'area_after': 1052, 'area_reduction': 228, 'area_reduction_percent': 17.8125, 'best_area_so_far': 1052}, {'step': 2, 'action': 'rw', 'area_before': 1052, 'area_after': 936, 'area_reduction': 116, 'area_reduction_percent': 11.02661596958175, 'best_area_so_far': 936}, {'step': 3, 'action': 'rf', 'area_before': 936, 'area_after': 929, 'area_reduction': 7, 'area_reduction_percent': 0.7478632478632479, 'best_area_so_far': 929}, {'step': 4, 'action': 'b', 'area_before': 929, 'area_after': 928, 'area_reduction': 1, 'area_reduction_percent': 0.1076426264800861, 'best_area_so_far': 928}, {'step': 5, 'action': 'rw', 'area_before': 928, 'area_after': 890, 'area_reduction': 38, 'area_reduction_percent': 4.094827586206897, 'best_area_so_far': 890}, {'step': 6, 'action': 'rwz', 'area_before': 890, 'area_after': 861, 'area_reduction': 29, 'area_reduction_percent': 3.258426966292135, 'best_area_so_far': 861}, {'step': 7, 'action': 'b', 'area_before': 861, 'area_after': 857, 'area_reduction': 4, 'area_reduction_percent': 0.4645760743321719, 'best_area_so_far': 857}, {'step': 8, 'action': 'rfz', 'area_before': 857, 'area_after': 849, 'area_reduction': 8, 'area_reduction_percent': 0.9334889148191364, 'best_area_so_far': 849}, {'step': 9, 'action': 'rwz', 'area_before': 849, 'area_after': 820, 'area_reduction': 29, 'area_reduction_percent': 3.415783274440518, 'best_area_so_far': 820}, {'step': 10, 'action': 'b', 'area_before': 820, 'area_after': 819, 'area_reduction': 1, 'area_reduction_percent': 0.12195121951219512, 'best_area_so_far': 819}]",10
testcase/IWLS/ex64/ex64.aag,ex64.aag,2645,2036,2036,609,23.024574669187146,"[{'step': 1, 'action': 'b', 'area_before': 2645, 'area_after': 2432, 'area_reduction': 213, 'area_reduction_percent': 8.052930056710775, 'best_area_so_far': 2432}, {'step': 2, 'action': 'rw', 'area_before': 2432, 'area_after': 2239, 'area_reduction': 193, 'area_reduction_percent': 7.935855263157894, 'best_area_so_far': 2239}, {'step': 3, 'action': 'rf', 'area_before': 2239, 'area_after': 2153, 'area_reduction': 86, 'area_reduction_percent': 3.841000446627959, 'best_area_so_far': 2153}, {'step': 4, 'action': 'b', 'area_before': 2153, 'area_after': 2140, 'area_reduction': 13, 'area_reduction_percent': 0.603808639108221, 'best_area_so_far': 2140}, {'step': 5, 'action': 'rw', 'area_before': 2140, 'area_after': 2112, 'area_reduction': 28, 'area_reduction_percent': 1.3084112149532712, 'best_area_so_far': 2112}, {'step': 6, 'action': 'rwz', 'area_before': 2112, 'area_after': 2096, 'area_reduction': 16, 'area_reduction_percent': 0.7575757575757576, 'best_area_so_far': 2096}, {'step': 7, 'action': 'b', 'area_before': 2096, 'area_after': 2092, 'area_reduction': 4, 'area_reduction_percent': 0.19083969465648853, 'best_area_so_far': 2092}, {'step': 8, 'action': 'rfz', 'area_before': 2092, 'area_after': 2072, 'area_reduction': 20, 'area_reduction_percent': 0.9560229445506693, 'best_area_so_far': 2072}, {'step': 9, 'action': 'rwz', 'area_before': 2072, 'area_after': 2039, 'area_reduction': 33, 'area_reduction_percent': 1.5926640926640927, 'best_area_so_far': 2039}, {'step': 10, 'action': 'b', 'area_before': 2039, 'area_after': 2036, 'area_reduction': 3, 'area_reduction_percent': 0.14713094654242276, 'best_area_so_far': 2036}]",10
testcase/MCNC/term1/term1.aag,term1.aag,130,116,116,14,10.76923076923077,"[{'step': 1, 'action': 'b', 'area_before': 130, 'area_after': 129, 'area_reduction': 1, 'area_reduction_percent': 0.7692307692307693, 'best_area_so_far': 129}, {'step': 2, 'action': 'rw', 'area_before': 129, 'area_after': 121, 'area_reduction': 8, 'area_reduction_percent': 6.2015503875969, 'best_area_so_far': 121}, {'step': 3, 'action': 'rf', 'area_before': 121, 'area_after': 118, 'area_reduction': 3, 'area_reduction_percent': 2.479338842975207, 'best_area_so_far': 118}, {'step': 4, 'action': 'b', 'area_before': 118, 'area_after': 118, 'area_reduction': 0, 'area_reduction_percent': 0.0, 'best_area_so_far': 118}, {'step': 5, 'action': 'rw', 'area_before': 118, 'area_after': 118, 'area_reduction': 0, 'area_reduction_percent': 0.0, 'best_area_so_far': 118}, {'step': 6, 'action': 'rwz', 'area_before': 118, 'area_after': 117, 'area_reduction': 1, 'area_reduction_percent': 0.847457627118644, 'best_area_so_far': 117}, {'step': 7, 'action': 'b', 'area_before': 117, 'area_after': 117, 'area_reduction': 0, 'area_reduction_percent': 0.0, 'best_area_so_far': 117}, {'step': 8, 'action': 'rfz', 'area_before': 117, 'area_after': 117, 'area_reduction': 0, 'area_reduction_percent': 0.0, 'best_area_so_far': 117}, {'step': 9, 'action': 'rwz', 'area_before': 117, 'area_after': 116, 'area_reduction': 1, 'area_reduction_percent': 0.8547008547008548, 'best_area_so_far': 116}, {'step': 10, 'action': 'b', 'area_before': 116, 'area_after': 116, 'area_reduction': 0, 'area_reduction_percent': 0.0, 'best_area_so_far': 116}]",10
testcase/MCNC/i10/i10.aag,i10.aag,2675,1829,1829,846,31.626168224299068,"[{'step': 1, 'action': 'b', 'area_before': 2675, 'area_after': 2396, 'area_reduction': 279, 'area_reduction_percent': 10.429906542056075, 'best_area_so_far': 2396}, {'step': 2, 'action': 'rw', 'area_before': 2396, 'area_after': 2046, 'area_reduction': 350, 'area_reduction_percent': 14.607679465776293, 'best_area_so_far': 2046}, {'step': 3, 'action': 'rf', 'area_before': 2046, 'area_after': 1989, 'area_reduction': 57, 'area_reduction_percent': 2.785923753665689, 'best_area_so_far': 1989}, {'step': 4, 'action': 'b', 'area_before': 1989, 'area_after': 1981, 'area_reduction': 8, 'area_reduction_percent': 0.40221216691804923, 'best_area_so_far': 1981}, {'step': 5, 'action': 'rw', 'area_before': 1981, 'area_after': 1943, 'area_reduction': 38, 'area_reduction_percent': 1.9182231196365473, 'best_area_so_far': 1943}, {'step': 6, 'action': 'rwz', 'area_before': 1943, 'area_after': 1872, 'area_reduction': 71, 'area_reduction_percent': 3.654143077714874, 'best_area_so_far': 1872}, {'step': 7, 'action': 'b', 'area_before': 1872, 'area_after': 1868, 'area_reduction': 4, 'area_reduction_percent': 0.2136752136752137, 'best_area_so_far': 1868}, {'step': 8, 'action': 'rfz', 'area_before': 1868, 'area_after': 1861, 'area_reduction': 7, 'area_reduction_percent': 0.3747323340471092, 'best_area_so_far': 1861}, {'step': 9, 'action': 'rwz', 'area_before': 1861, 'area_after': 1831, 'area_reduction': 30, 'area_reduction_percent': 1.6120365394948952, 'best_area_so_far': 1831}, {'step': 10, 'action': 'b', 'area_before': 1831, 'area_after': 1829, 'area_reduction': 2, 'area_reduction_percent': 0.10922992900054614, 'best_area_so_far': 1829}]",10
testcase/IWLS/ex11/ex11.aag,ex11.aag,48,23,23,25,52.083333333333336,"[{'step': 1, 'action': 'b', 'area_before': 48, 'area_after': 46, 'area_reduction': 2, 'area_reduction_percent': 4.166666666666666, 'best_area_so_far': 46}, {'step': 2, 'action': 'rw', 'area_before': 46, 'area_after': 37, 'area_reduction': 9, 'area_reduction_percent': 19.565217391304348, 'best_area_so_far': 37}, {'step': 3, 'action': 'rf', 'area_before': 37, 'area_after': 28, 'area_reduction': 9, 'area_reduction_percent': 24.324324324324326, 'best_area_so_far': 28}, {'step': 4, 'action': 'b', 'area_before': 28, 'area_after': 27, 'area_reduction': 1, 'area_reduction_percent': 3.571428571428571, 'best_area_so_far': 27}, {'step': 5, 'action': 'rw', 'area_before': 27, 'area_after': 25, 'area_reduction': 2, 'area_reduction_percent': 7.4074074074074066, 'best_area_so_far': 25}, {'step': 6, 'action': 'rwz', 'area_before': 25, 'area_after': 23, 'area_reduction': 2, 'area_reduction_percent': 8.0, 'best_area_so_far': 23}, {'step': 7, 'action': 'b', 'area_before': 23, 'area_after': 23, 'area_reduction': 0, 'area_reduction_percent': 0.0, 'best_area_so_far': 23}, {'step': 8, 'action': 'rfz', 'area_before': 23, 'area_after': 23, 'area_reduction': 0, 'area_reduction_percent': 0.0, 'best_area_so_far': 23}, {'step': 9, 'action': 'rwz', 'area_before': 23, 'area_after': 23, 'area_reduction': 0, 'area_reduction_percent': 0.0, 'best_area_so_far': 23}, {'step': 10, 'action': 'b', 'area_before': 23, 'area_after': 23, 'area_reduction': 0, 'area_reduction_percent': 0.0, 'best_area_so_far': 23}]",10
testcase/IWLS/ex136/ex136.aag,ex136.aag,2110,1646,1646,464,21.990521327014218,"[{'step': 1, 'action': 'b', 'area_before': 2110, 'area_after': 1961, 'area_reduction': 149, 'area_reduction_percent': 7.061611374407582, 'best_area_so_far': 1961}, {'step': 2, 'action': 'rw', 'area_before': 1961, 'area_after': 1819, 'area_reduction': 142, 'area_reduction_percent': 7.241203467618562, 'best_area_so_far': 1819}, {'step': 3, 'action': 'rf', 'area_before': 1819, 'area_after': 1760, 'area_reduction': 59, 'area_reduction_percent': 3.2435404068169325, 'best_area_so_far': 1760}, {'step': 4, 'action': 'b', 'area_before': 1760, 'area_after': 1750, 'area_reduction': 10, 'area_reduction_percent': 0.5681818181818182, 'best_area_so_far': 1750}, {'step': 5, 'action': 'rw', 'area_before': 1750, 'area_after': 1716, 'area_reduction': 34, 'area_reduction_percent': 1.9428571428571426, 'best_area_so_far': 1716}, {'step': 6, 'action': 'rwz', 'area_before': 1716, 'area_after': 1705, 'area_reduction': 11, 'area_reduction_percent': 0.641025641025641, 'best_area_so_far': 1705}, {'step': 7, 'action': 'b', 'area_before': 1705, 'area_after': 1705, 'area_reduction': 0, 'area_reduction_percent': 0.0, 'best_area_so_far': 1705}, {'step': 8, 'action': 'rfz', 'area_before': 1705, 'area_after': 1690, 'area_reduction': 15, 'area_reduction_percent': 0.8797653958944283, 'best_area_so_far': 1690}, {'step': 9, 'action': 'rwz', 'area_before': 1690, 'area_after': 1649, 'area_reduction': 41, 'area_reduction_percent': 2.42603550295858, 'best_area_so_far': 1649}, {'step': 10, 'action': 'b', 'area_before': 1649, 'area_after': 1646, 'area_reduction': 3, 'area_reduction_percent': 0.18192844147968465, 'best_area_so_far': 1646}]",10
testcase/MCNC/soar/soar.aag,soar.aag,724,503,503,221,30.52486187845304,"[{'step': 1, 'action': 'b', 'area_before': 724, 'area_after': 618, 'area_reduction': 106, 'area_reduction_percent': 14.64088397790055, 'best_area_so_far': 618}, {'step': 2, 'action': 'rw', 'area_before': 618, 'area_after': 558, 'area_reduction': 60, 'area_reduction_percent': 9.70873786407767, 'best_area_so_far': 558}, {'step': 3, 'action': 'rf', 'area_before': 558, 'area_after': 544, 'area_reduction': 14, 'area_reduction_percent': 2.5089605734767026, 'best_area_so_far': 544}, {'step': 4, 'action': 'b', 'area_before': 544, 'area_after': 542, 'area_reduction': 2, 'area_reduction_percent': 0.3676470588235294, 'best_area_so_far': 542}, {'step': 5, 'action': 'rw', 'area_before': 542, 'area_after': 534, 'area_reduction': 8, 'area_reduction_percent': 1.4760147601476015, 'best_area_so_far': 534}, {'step': 6, 'action': 'rwz', 'area_before': 534, 'area_after': 530, 'area_reduction': 4, 'area_reduction_percent': 0.7490636704119851, 'best_area_so_far': 530}, {'step': 7, 'action': 'b', 'area_before': 530, 'area_after': 530, 'area_reduction': 0, 'area_reduction_percent': 0.0, 'best_area_so_far': 530}, {'step': 8, 'action': 'rfz', 'area_before': 530, 'area_after': 527, 'area_reduction': 3, 'area_reduction_percent': 0.5660377358490566, 'best_area_so_far': 527}, {'step': 9, 'action': 'rwz', 'area_before': 527, 'area_after': 509, 'area_reduction': 18, 'area_reduction_percent': 3.415559772296015, 'best_area_so_far': 509}, {'step': 10, 'action': 'b', 'area_before': 509, 'area_after': 503, 'area_reduction': 6, 'area_reduction_percent': 1.1787819253438114, 'best_area_so_far': 503}]",10
testcase/IWLS/ex86/ex86.aag,ex86.aag,783,537,537,246,31.417624521072796,"[{'step': 1, 'action': 'b', 'area_before': 783, 'area_after': 741, 'area_reduction': 42, 'area_reduction_percent': 5.363984674329502, 'best_area_so_far': 741}, {'step': 2, 'action': 'rw', 'area_before': 741, 'area_after': 653, 'area_reduction': 88, 'area_reduction_percent': 11.875843454790823, 'best_area_so_far': 653}, {'step': 3, 'action': 'rf', 'area_before': 653, 'area_after': 601, 'area_reduction': 52, 'area_reduction_percent': 7.9632465543644715, 'best_area_so_far': 601}, {'step': 4, 'action': 'b', 'area_before': 601, 'area_after': 591, 'area_reduction': 10, 'area_reduction_percent': 1.6638935108153077, 'best_area_so_far': 591}, {'step': 5, 'action': 'rw', 'area_before': 591, 'area_after': 566, 'area_reduction': 25, 'area_reduction_percent': 4.230118443316413, 'best_area_so_far': 566}, {'step': 6, 'action': 'rwz', 'area_before': 566, 'area_after': 557, 'area_reduction': 9, 'area_reduction_percent': 1.5901060070671376, 'best_area_so_far': 557}, {'step': 7, 'action': 'b', 'area_before': 557, 'area_after': 552, 'area_reduction': 5, 'area_reduction_percent': 0.8976660682226212, 'best_area_so_far': 552}, {'step': 8, 'action': 'rfz', 'area_before': 552, 'area_after': 544, 'area_reduction': 8, 'area_reduction_percent': 1.4492753623188406, 'best_area_so_far': 544}, {'step': 9, 'action': 'rwz', 'area_before': 544, 'area_after': 538, 'area_reduction': 6, 'area_reduction_percent': 1.1029411764705883, 'best_area_so_far': 538}, {'step': 10, 'action': 'b', 'area_before': 538, 'area_after': 537, 'area_reduction': 1, 'area_reduction_percent': 0.18587360594795538, 'best_area_so_far': 537}]",10
testcase/IWLS/ex69/ex69.aag,ex69.aag,1236,1019,1019,217,17.55663430420712,"[{'step': 1, 'action': 'b', 'area_before': 1236, 'area_after': 1165, 'area_reduction': 71, 'area_reduction_percent': 5.744336569579287, 'best_area_so_far': 1165}, {'step': 2, 'action': 'rw', 'area_before': 1165, 'area_after': 1089, 'area_reduction': 76, 'area_reduction_percent': 6.523605150214593, 'best_area_so_far': 1089}, {'step': 3, 'action': 'rf', 'area_before': 1089, 'area_after': 1070, 'area_reduction': 19, 'area_reduction_percent': 1.7447199265381086, 'best_area_so_far': 1070}, {'step': 4, 'action': 'b', 'area_before': 1070, 'area_after': 1067, 'area_reduction': 3, 'area_reduction_percent': 0.2803738317757009, 'best_area_so_far': 1067}, {'step': 5, 'action': 'rw', 'area_before': 1067, 'area_after': 1054, 'area_reduction': 13, 'area_reduction_percent': 1.218369259606373, 'best_area_so_far': 1054}, {'step': 6, 'action': 'rwz', 'area_before': 1054, 'area_after': 1044, 'area_reduction': 10, 'area_reduction_percent': 0.9487666034155597, 'best_area_so_far': 1044}, {'step': 7, 'action': 'b', 'area_before': 1044, 'area_after': 1041, 'area_reduction': 3, 'area_reduction_percent': 0.28735632183908044, 'best_area_so_far': 1041}, {'step': 8, 'action': 'rfz', 'area_before': 1041, 'area_after': 1037, 'area_reduction': 4, 'area_reduction_percent': 0.38424591738712777, 'best_area_so_far': 1037}, {'step': 9, 'action': 'rwz', 'area_before': 1037, 'area_after': 1021, 'area_reduction': 16, 'area_reduction_percent': 1.5429122468659595, 'best_area_so_far': 1021}, {'step': 10, 'action': 'b', 'area_before': 1021, 'area_after': 1019, 'area_reduction': 2, 'area_reduction_percent': 0.1958863858961802, 'best_area_so_far': 1019}]",10
testcase/IWLS/ex98/ex98.aag,ex98.aag,989,756,756,233,23.559150657229523,"[{'step': 1, 'action': 'b', 'area_before': 989, 'area_after': 917, 'area_reduction': 72, 'area_reduction_percent': 7.280080889787664, 'best_area_so_far': 917}, {'step': 2, 'action': 'rw', 'area_before': 917, 'area_after': 838, 'area_reduction': 79, 'area_reduction_percent': 8.615049073064341, 'best_area_so_far': 838}, {'step': 3, 'action': 'rf', 'area_before': 838, 'area_after': 801, 'area_reduction': 37, 'area_reduction_percent': 4.41527446300716, 'best_area_so_far': 801}, {'step': 4, 'action': 'b', 'area_before': 801, 'area_after': 794, 'area_reduction': 7, 'area_reduction_percent': 0.8739076154806492, 'best_area_so_far': 794}, {'step': 5, 'action': 'rw', 'area_before': 794, 'area_after': 777, 'area_reduction': 17, 'area_reduction_percent': 2.141057934508816, 'best_area_so_far': 777}, {'step': 6, 'action': 'rwz', 'area_before': 777, 'area_after': 772, 'area_reduction': 5, 'area_reduction_percent': 0.6435006435006435, 'best_area_so_far': 772}, {'step': 7, 'action': 'b', 'area_before': 772, 'area_after': 771, 'area_reduction': 1, 'area_reduction_percent': 0.1295336787564767, 'best_area_so_far': 771}, {'step': 8, 'action': 'rfz', 'area_before': 771, 'area_after': 770, 'area_reduction': 1, 'area_reduction_percent': 0.12970168612191957, 'best_area_so_far': 770}, {'step': 9, 'action': 'rwz', 'area_before': 770, 'area_after': 758, 'area_reduction': 12, 'area_reduction_percent': 1.5584415584415585, 'best_area_so_far': 758}, {'step': 10, 'action': 'b', 'area_before': 758, 'area_after': 756, 'area_reduction': 2, 'area_reduction_percent': 0.2638522427440633, 'best_area_so_far': 756}]",10
